season,team_abbrv,coach_name,games_coached,games_W,games_L,playoff_games,playoff_games_W,playoff_games_L,team_coach_number,seasons_with_team,new_coach
1960,BOS,Red Auerbach,75,59,16,13,8,5,1,10,0
1960,CIN,Tom Marshall,75,19,56,0,0,0,1,2,0
1960,DET,Red Rocha,34,13,21,0,0,0,1,3,0
1960,DET,Dick McGuire,41,17,24,2,0,2,2,1,1
1960,MNL,John Castellani,36,11,25,0,0,0,1,1,1
1960,MNL,Jim Pollard,39,14,25,9,5,4,2,1,1
1960,NYK,Andrew Levane,27,8,19,0,0,0,1,2,0
1960,NYK,Carl Braun,48,19,29,0,0,0,2,1,1
1960,PHW,Neil Johnston,75,49,26,9,4,5,1,1,1
1960,STL,Ed Macauley,75,46,29,14,7,7,1,2,0
1960,SYR,Paul Seymour,75,45,30,3,1,2,1,4,0
1961,BOS,Red Auerbach,79,57,22,10,8,2,1,11,0
1961,CIN,Charles Wolf,79,33,46,0,0,0,1,1,1
1961,DET,Dick McGuire,79,34,45,5,2,3,1,2,0
1961,LAL,Fred Schaus,79,36,43,12,6,6,1,1,1
1961,NYK,Carl Braun,79,21,58,0,0,0,1,2,0
1961,PHW,Neil Johnston,79,46,33,3,0,3,1,2,0
1961,STL,Paul Seymour,79,51,28,12,5,7,1,1,1
1961,SYR,Alex Hannum,79,38,41,8,4,4,1,1,1
1962,BOS,Red Auerbach,80,60,20,14,8,6,1,12,0
1962,CHP,Jim Pollard,80,18,62,0,0,0,1,1,1
1962,CIN,Charles Wolf,80,43,37,4,1,3,1,2,0
1962,DET,Dick McGuire,80,37,43,10,5,5,1,3,0
1962,LAL,Fred Schaus,80,54,26,13,7,6,1,2,0
1962,NYK,Eddie Donovan,80,29,51,0,0,0,1,1,1
1962,PHW,Frank McGuire,80,49,31,12,6,6,1,1,1
1962,STL,Paul Seymour,14,5,9,0,0,0,1,2,0
1962,STL,Andrew Levane,60,20,40,0,0,0,2,3,0
1962,STL,Bob Pettit,6,4,2,0,0,0,3,1,1
1962,SYR,Alex Hannum,80,41,39,5,2,3,1,2,0
1963,BOS,Red Auerbach,80,58,22,13,8,5,1,13,0
1963,CHZ,Jack McMahon,38,12,26,0,0,0,1,1,1
1963,CHZ,Slick Leonard,42,13,29,0,0,0,2,1,1
1963,CIN,Charles Wolf,80,42,38,12,6,6,1,3,0
1963,DET,Dick McGuire,80,34,46,4,1,3,1,4,0
1963,LAL,Fred Schaus,80,53,27,13,6,7,1,3,0
1963,NYK,Eddie Donovan,80,21,59,0,0,0,1,2,0
1963,SFW,Bob Feerick,80,31,49,0,0,0,1,1,1
1963,STL,Harry Gallatin,80,48,32,11,6,5,1,1,1
1963,SYR,Alex Hannum,80,48,32,5,2,3,1,3,0
1964,BAL,Slick Leonard,80,31,49,0,0,0,1,2,0
1964,BOS,Red Auerbach,80,59,21,10,8,2,1,14,0
1964,CIN,Jack McMahon,80,55,25,10,4,6,1,1,1
1964,DET,Charles Wolf,80,23,57,0,0,0,1,1,1
1964,LAL,Fred Schaus,80,42,38,5,2,3,1,4,0
1964,NYK,Eddie Donovan,80,22,58,0,0,0,1,3,0
1964,PHI,Dolph Schayes,80,34,46,5,2,3,1,1,1
1964,SFW,Alex Hannum,80,48,32,12,5,7,1,1,1
1964,STL,Harry Gallatin,80,46,34,12,6,6,1,2,0
1965,BAL,Buddy Jeannette,80,37,43,10,5,5,1,1,1
1965,BOS,Red Auerbach,80,62,18,12,8,4,1,15,0
1965,CIN,Jack McMahon,80,48,32,4,1,3,1,2,0
1965,DET,Charles Wolf,11,2,9,0,0,0,1,2,0
1965,DET,Dave DeBusschere,69,29,40,0,0,0,2,1,1
1965,LAL,Fred Schaus,80,49,31,11,5,6,1,5,0
1965,NYK,Eddie Donovan,38,12,26,0,0,0,1,4,0
1965,NYK,Harry Gallatin,42,19,23,0,0,0,2,1,1
1965,PHI,Dolph Schayes,80,40,40,11,6,5,1,2,0
1965,SFW,Alex Hannum,80,17,63,0,0,0,1,2,0
1965,STL,Harry Gallatin,33,17,16,0,0,0,1,3,0
1965,STL,Richie Guerin,47,28,19,4,1,3,2,1,1
1966,BAL,Paul Seymour,80,38,42,3,0,3,1,1,1
1966,BOS,Red Auerbach,80,54,26,17,11,6,1,16,0
1966,CIN,Jack McMahon,80,45,35,5,2,3,1,3,0
1966,DET,Dave DeBusschere,80,22,58,0,0,0,1,2,0
1966,LAL,Fred Schaus,80,45,35,14,7,7,1,6,0
1966,NYK,Harry Gallatin,21,6,15,0,0,0,1,2,0
1966,NYK,Dick McGuire,59,24,35,0,0,0,2,1,1
1966,PHI,Dolph Schayes,80,55,25,5,1,4,1,3,0
1966,SFW,Alex Hannum,80,35,45,0,0,0,1,3,0
1966,STL,Richie Guerin,80,36,44,10,6,4,1,2,0
1967,BAL,Mike Farmer,9,1,8,0,0,0,1,1,1
1967,BAL,Buddy Jeannette,16,3,13,0,0,0,2,2,0
1967,BAL,Gene Shue,56,16,40,0,0,0,3,1,1
1967,BOS,Bill Russell,81,60,21,9,4,5,1,1,1
1967,CHI,Red Kerr,81,33,48,3,0,3,1,1,1
1967,CIN,Jack McMahon,81,39,42,4,1,3,1,4,0
1967,DET,Dave DeBusschere,73,28,45,0,0,0,1,3,0
1967,DET,Donnie Butcher,8,2,6,0,0,0,2,1,1
1967,LAL,Fred Schaus,81,36,45,3,0,3,1,7,0
1967,NYK,Dick McGuire,81,36,45,4,1,3,1,2,0
1967,PHI,Alex Hannum,81,68,13,15,11,4,1,4,0
1967,SFW,Bill Sharman,81,44,37,15,9,6,1,1,1
1967,STL,Richie Guerin,81,39,42,9,5,4,1,3,0
1968,BAL,Gene Shue,82,36,46,0,0,0,1,2,0
1968,BOS,Bill Russell,82,54,28,19,12,7,1,2,0
1968,CHI,Red Kerr,82,29,53,5,1,4,1,2,0
1968,CIN,Ed Jucker,82,39,43,0,0,0,1,1,1
1968,DET,Donnie Butcher,82,40,42,6,2,4,1,2,0
1968,LAL,Butch van Breda Kolff,82,52,30,15,10,5,1,1,1
1968,NYK,Dick McGuire,38,15,23,0,0,0,1,3,0
1968,NYK,Red Holzman,44,28,16,6,2,4,2,1,1
1968,PHI,Alex Hannum,82,62,20,13,7,6,1,5,0
1968,SDR,Jack McMahon,82,15,67,0,0,0,1,1,1
1968,SEA,Al Bianchi,82,23,59,0,0,0,1,1,1
1968,SFW,Bill Sharman,82,43,39,10,4,6,1,2,0
1968,STL,Richie Guerin,82,56,26,6,2,4,1,4,0
1969,ATL,Richie Guerin,82,48,34,11,5,6,1,5,0
1969,BAL,Gene Shue,82,57,25,4,0,4,1,3,0
1969,BOS,Bill Russell,82,48,34,18,12,6,1,3,0
1969,CHI,Dick Motta,82,33,49,0,0,0,1,1,1
1969,CIN,Ed Jucker,82,41,41,0,0,0,1,2,0
1969,DET,Donnie Butcher,22,10,12,0,0,0,1,3,0
1969,DET,Paul Seymour,60,22,38,0,0,0,2,1,1
1969,LAL,Butch van Breda Kolff,82,55,27,18,11,7,1,2,0
1969,MIL,Larry Costello,82,27,55,0,0,0,1,1,1
1969,NYK,Red Holzman,82,54,28,10,6,4,1,2,0
1969,PHI,Jack Ramsay,82,55,27,5,1,4,1,1,1
1969,PHO,Red Kerr,82,16,66,0,0,0,1,1,1
1969,SDR,Jack McMahon,82,37,45,6,2,4,1,2,0
1969,SEA,Al Bianchi,82,30,52,0,0,0,1,2,0
1969,SFW,George Lee,82,41,41,6,2,4,1,1,1
1970,ATL,Richie Guerin,82,48,34,9,4,5,1,6,0
1970,BAL,Gene Shue,82,50,32,7,3,4,1,4,0
1970,BOS,Tom Heinsohn,82,34,48,0,0,0,1,1,1
1970,CHI,Dick Motta,82,39,43,5,1,4,1,2,0
1970,CIN,Bob Cousy,82,36,46,0,0,0,1,1,1
1970,DET,Butch van Breda Kolff,82,31,51,0,0,0,1,1,1
1970,LAL,Joe Mullaney,82,46,36,18,11,7,1,1,1
1970,MIL,Larry Costello,82,56,26,10,5,5,1,2,0
1970,NYK,Red Holzman,82,60,22,19,12,7,1,3,0
1970,PHI,Jack Ramsay,82,42,40,5,1,4,1,2,0
1970,PHO,Red Kerr,38,15,23,0,0,0,1,2,0
1970,PHO,Jerry Colangelo,44,24,20,7,3,4,2,1,1
1970,SDR,Jack McMahon,26,9,17,0,0,0,1,3,0
1970,SDR,Alex Hannum,56,18,38,0,0,0,2,1,1
1970,SEA,Lenny Wilkens,82,36,46,0,0,0,1,1,1
1970,SFW,George Lee,52,22,30,0,0,0,1,2,0
1970,SFW,Al Attles,30,8,22,0,0,0,2,1,1
1971,ATL,Richie Guerin,82,36,46,5,1,4,1,7,0
1971,BAL,Gene Shue,82,42,40,18,8,10,1,5,0
1971,BOS,Tom Heinsohn,82,44,38,0,0,0,1,2,0
1971,BUF,Dolph Schayes,82,22,60,0,0,0,1,1,1
1971,CHI,Dick Motta,82,51,31,7,3,4,1,3,0
1971,CIN,Bob Cousy,82,33,49,0,0,0,1,2,0
1971,CLE,Bill Fitch,82,15,67,0,0,0,1,1,1
1971,DET,Butch van Breda Kolff,82,45,37,0,0,0,1,2,0
1971,LAL,Joe Mullaney,82,48,34,12,5,7,1,2,0
1971,MIL,Larry Costello,82,66,16,14,12,2,1,3,0
1971,NYK,Red Holzman,82,52,30,12,7,5,1,4,0
1971,PHI,Jack Ramsay,82,47,35,7,3,4,1,3,0
1971,PHO,Cotton Fitzsimmons,82,48,34,0,0,0,1,1,1
1971,POR,Rolland Todd,82,29,53,0,0,0,1,1,1
1971,SDR,Alex Hannum,82,40,42,0,0,0,1,2,0
1971,SEA,Lenny Wilkens,82,38,44,0,0,0,1,2,0
1971,SFW,Al Attles,82,41,41,5,1,4,1,2,0
1972,ATL,Richie Guerin,82,36,46,6,2,4,1,8,0
1972,BAL,Gene Shue,82,38,44,6,2,4,1,6,0
1972,BOS,Tom Heinsohn,82,56,26,11,5,6,1,3,0
1972,BUF,Dolph Schayes,1,0,1,0,0,0,1,2,0
1972,BUF,Johnny McCarthy,81,22,59,0,0,0,2,1,1
1972,CHI,Dick Motta,82,57,25,4,0,4,1,4,0
1972,CIN,Bob Cousy,82,30,52,0,0,0,1,3,0
1972,CLE,Bill Fitch,82,23,59,0,0,0,1,2,0
1972,DET,Butch van Breda Kolff,10,6,4,0,0,0,1,3,0
1972,DET,Terry Dischinger,2,0,2,0,0,0,2,1,1
1972,DET,Earl Lloyd,70,20,50,0,0,0,3,1,1
1972,GSW,Al Attles,82,51,31,5,1,4,1,3,0
1972,HOU,Tex Winter,82,34,48,0,0,0,1,1,1
1972,LAL,Bill Sharman,82,69,13,15,12,3,1,1,1
1972,MIL,Larry Costello,82,63,19,11,6,5,1,4,0
1972,NYK,Red Holzman,82,48,34,16,9,7,1,5,0
1972,PHI,Jack Ramsay,82,30,52,0,0,0,1,4,0
1972,PHO,Cotton Fitzsimmons,82,49,33,0,0,0,1,2,0
1972,POR,Rolland Todd,56,12,44,0,0,0,1,2,0
1972,POR,Stu Inman,26,6,20,0,0,0,2,1,1
1972,SEA,Lenny Wilkens,82,47,35,0,0,0,1,3,0
1973,ATL,Cotton Fitzsimmons,82,46,36,6,2,4,1,1,1
1973,BAL,Gene Shue,82,52,30,5,1,4,1,7,0
1973,BOS,Tom Heinsohn,82,68,14,13,7,6,1,4,0
1973,BUF,Jack Ramsay,82,21,61,0,0,0,1,1,1
1973,CHI,Dick Motta,82,51,31,7,3,4,1,5,0
1973,CLE,Bill Fitch,82,32,50,0,0,0,1,3,0
1973,DET,Earl Lloyd,7,2,5,0,0,0,1,2,0
1973,DET,Ray Scott,75,38,37,0,0,0,2,1,1
1973,GSW,Al Attles,82,47,35,11,5,6,1,4,0
1973,HOU,Tex Winter,47,17,30,0,0,0,1,2,0
1973,HOU,Johnny Egan,35,16,19,0,0,0,2,1,1
1973,KCO,Bob Cousy,82,36,46,0,0,0,1,4,0
1973,LAL,Bill Sharman,82,60,22,17,9,8,1,2,0
1973,MIL,Larry Costello,82,60,22,6,2,4,1,5,0
1973,NYK,Red Holzman,82,57,25,17,12,5,1,6,0
1973,PHI,Roy Rubin,51,4,47,0,0,0,1,1,1
1973,PHI,Kevin Loughery,31,5,26,0,0,0,2,1,1
1973,PHO,Butch van Breda Kolff,7,3,4,0,0,0,1,1,1
1973,PHO,Jerry Colangelo,75,35,40,0,0,0,2,2,0
1973,POR,Jack McCloskey,82,21,61,0,0,0,1,1,1
1973,SEA,Tom Nissalke,45,13,32,0,0,0,1,1,1
1973,SEA,Bucky Buckwalter,37,13,24,0,0,0,2,1,1
1974,ATL,Cotton Fitzsimmons,82,35,47,0,0,0,1,2,0
1974,BOS,Tom Heinsohn,82,56,26,18,12,6,1,5,0
1974,BUF,Jack Ramsay,82,42,40,6,2,4,1,2,0
1974,CAP,K.C. Jones,82,47,35,7,3,4,1,1,1
1974,CHI,Dick Motta,82,54,28,11,4,7,1,6,0
1974,CLE,Bill Fitch,82,29,53,0,0,0,1,4,0
1974,DET,Ray Scott,82,52,30,7,3,4,1,2,0
1974,GSW,Al Attles,82,44,38,0,0,0,1,5,0
1974,HOU,Johnny Egan,82,32,50,0,0,0,1,2,0
1974,KCO,Bob Cousy,20,6,14,0,0,0,1,5,0
1974,KCO,Draff Young,4,0,4,0,0,0,2,1,1
1974,KCO,Phil Johnson,58,27,31,0,0,0,3,1,1
1974,LAL,Bill Sharman,82,47,35,5,1,4,1,3,0
1974,MIL,Larry Costello,82,59,23,16,11,5,1,6,0
1974,NYK,Red Holzman,82,49,33,12,5,7,1,7,0
1974,PHI,Gene Shue,82,25,57,0,0,0,1,1,1
1974,PHO,John MacLeod,82,30,52,0,0,0,1,1,1
1974,POR,Jack McCloskey,82,27,55,0,0,0,1,2,0
1974,SEA,Bill Russell,82,36,46,0,0,0,1,1,1
1975,ATL,Cotton Fitzsimmons,82,31,51,0,0,0,1,3,0
1975,BOS,Tom Heinsohn,82,60,22,11,6,5,1,6,0
1975,BUF,Jack Ramsay,82,49,33,7,3,4,1,3,0
1975,CHI,Dick Motta,82,47,35,13,7,6,1,7,0
1975,CLE,Bill Fitch,82,40,42,0,0,0,1,5,0
1975,DET,Ray Scott,82,40,42,3,1,2,1,3,0
1975,GSW,Al Attles,82,48,34,17,12,5,1,6,0
1975,HOU,Johnny Egan,82,41,41,8,3,5,1,3,0
1975,KCO,Phil Johnson,82,44,38,6,2,4,1,2,0
1975,LAL,Bill Sharman,82,30,52,0,0,0,1,4,0
1975,MIL,Larry Costello,82,38,44,0,0,0,1,7,0
1975,NOJ,Scotty Robertson,15,1,14,0,0,0,1,1,1
1975,NOJ,Elgin Baylor,1,0,1,0,0,0,2,1,1
1975,NOJ,Butch van Breda Kolff,66,22,44,0,0,0,3,1,1
1975,NYK,Red Holzman,82,40,42,3,1,2,1,8,0
1975,PHI,Gene Shue,82,34,48,0,0,0,1,2,0
1975,PHO,John MacLeod,82,32,50,0,0,0,1,2,0
1975,POR,Lenny Wilkens,82,38,44,0,0,0,1,1,1
1975,SEA,Bill Russell,82,43,39,9,4,5,1,2,0
1975,WSB,K.C. Jones,82,60,22,17,8,9,1,2,0
1976,ATL,Cotton Fitzsimmons,74,28,46,0,0,0,1,4,0
1976,ATL,Gene Tormohlen,8,1,7,0,0,0,2,1,1
1976,BOS,Tom Heinsohn,82,54,28,18,12,6,1,7,0
1976,BUF,Jack Ramsay,82,46,36,9,4,5,1,4,0
1976,CHI,Dick Motta,82,24,58,0,0,0,1,8,0
1976,CLE,Bill Fitch,82,49,33,13,6,7,1,6,0
1976,DET,Ray Scott,42,17,25,0,0,0,1,4,0
1976,DET,Herb Brown,40,19,21,9,4,5,2,1,1
1976,GSW,Al Attles,82,59,23,13,7,6,1,7,0
1976,HOU,Johnny Egan,82,40,42,0,0,0,1,4,0
1976,KCK,Phil Johnson,82,31,51,0,0,0,1,3,0
1976,LAL,Bill Sharman,82,40,42,0,0,0,1,5,0
1976,MIL,Larry Costello,82,38,44,3,1,2,1,8,0
1976,NOJ,Butch van Breda Kolff,82,38,44,0,0,0,1,2,0
1976,NYK,Red Holzman,82,38,44,0,0,0,1,9,0
1976,PHI,Gene Shue,82,46,36,3,1,2,1,3,0
1976,PHO,John MacLeod,82,42,40,19,10,9,1,3,0
1976,POR,Lenny Wilkens,82,37,45,0,0,0,1,2,0
1976,SEA,Bill Russell,82,43,39,6,2,4,1,3,0
1976,WSB,K.C. Jones,82,48,34,7,3,4,1,3,0
1977,ATL,Hubie Brown,82,31,51,0,0,0,1,1,1
1977,BOS,Tom Heinsohn,82,44,38,9,5,4,1,8,0
1977,BUF,Tates Locke,46,16,30,0,0,0,1,1,1
1977,BUF,Bob MacKinnon,7,3,4,0,0,0,2,1,1
1977,BUF,Joe Mullaney,29,11,18,0,0,0,3,1,1
1977,CHI,Ed Badger,82,44,38,3,1,2,1,1,1
1977,CLE,Bill Fitch,82,43,39,3,1,2,1,7,0
1977,DEN,Larry Brown,82,50,32,6,2,4,1,3,0
1977,DET,Herb Brown,82,44,38,3,1,2,1,2,0
1977,GSW,Al Attles,82,46,36,10,5,5,1,8,0
1977,HOU,Tom Nissalke,82,49,33,12,6,6,1,1,1
1977,IND,Slick Leonard,82,36,46,0,0,0,1,9,0
1977,KCK,Phil Johnson,82,40,42,0,0,0,1,4,0
1977,LAL,Jerry West,82,53,29,11,4,7,1,1,1
1977,MIL,Larry Costello,18,3,15,0,0,0,1,9,0
1977,MIL,Don Nelson,64,27,37,0,0,0,2,1,1
1977,NOJ,Butch van Breda Kolff,26,14,12,0,0,0,1,3,0
1977,NOJ,Elgin Baylor,56,21,35,0,0,0,2,2,0
1977,NYK,Red Holzman,82,40,42,0,0,0,1,10,0
1977,NYN,Kevin Loughery,82,22,60,0,0,0,1,4,0
1977,PHI,Gene Shue,82,50,32,19,10,9,1,4,0
1977,PHO,John MacLeod,82,34,48,0,0,0,1,4,0
1977,POR,Jack Ramsay,82,49,33,19,14,5,1,1,1
1977,SAS,Doug Moe,82,44,38,2,0,2,1,1,1
1977,SEA,Bill Russell,82,40,42,0,0,0,1,4,0
1977,WSB,Dick Motta,82,48,34,9,4,5,1,1,1
1978,ATL,Hubie Brown,82,41,41,2,0,2,1,2,0
1978,BOS,Tom Heinsohn,34,11,23,0,0,0,1,9,0
1978,BOS,Tom Sanders,48,21,27,0,0,0,2,1,1
1978,BUF,Cotton Fitzsimmons,82,27,55,0,0,0,1,1,1
1978,CHI,Ed Badger,82,40,42,0,0,0,1,2,0
1978,CLE,Bill Fitch,82,43,39,2,0,2,1,8,0
1978,DEN,Larry Brown,82,48,34,13,6,7,1,4,0
1978,DET,Herb Brown,24,9,15,0,0,0,1,3,0
1978,DET,Bob Kauffman,58,29,29,0,0,0,2,1,1
1978,GSW,Al Attles,82,43,39,0,0,0,1,9,0
1978,HOU,Tom Nissalke,82,28,54,0,0,0,1,2,0
1978,IND,Slick Leonard,82,31,51,0,0,0,1,10,0
1978,KCK,Phil Johnson,37,13,24,0,0,0,1,5,0
1978,KCK,Larry Staverman,45,18,27,0,0,0,2,1,1
1978,LAL,Jerry West,82,45,37,3,1,2,1,2,0
1978,MIL,Don Nelson,82,44,38,9,5,4,1,2,0
1978,NJN,Kevin Loughery,82,24,58,0,0,0,1,5,0
1978,NOJ,Elgin Baylor,82,39,43,0,0,0,1,3,0
1978,NYK,Willis Reed,82,43,39,6,2,4,1,1,1
1978,PHI,Gene Shue,6,2,4,0,0,0,1,5,0
1978,PHI,Billy Cunningham,76,53,23,10,6,4,2,1,1
1978,PHO,John MacLeod,82,49,33,2,0,2,1,5,0
1978,POR,Jack Ramsay,82,58,24,6,2,4,1,2,0
1978,SAS,Doug Moe,82,52,30,6,2,4,1,2,0
1978,SEA,Bob Hopkins,22,5,17,0,0,0,1,1,1
1978,SEA,Lenny Wilkens,60,42,18,22,13,9,2,4,0
1978,WSB,Dick Motta,82,44,38,21,14,7,1,2,0
1979,ATL,Hubie Brown,82,46,36,9,5,4,1,3,0
1979,BOS,Tom Sanders,14,2,12,0,0,0,1,2,0
1979,BOS,Dave Cowens,68,27,41,0,0,0,2,1,1
1979,CHI,Larry Costello,56,20,36,0,0,0,1,1,1
1979,CHI,Scotty Robertson,26,11,15,0,0,0,2,1,1
1979,CLE,Bill Fitch,82,30,52,0,0,0,1,9,0
1979,DEN,Larry Brown,53,28,25,0,0,0,1,5,0
1979,DEN,Donnie Walsh,29,19,10,3,1,2,2,1,1
1979,DET,Dick Vitale,82,30,52,0,0,0,1,1,1
1979,GSW,Al Attles,82,38,44,0,0,0,1,10,0
1979,HOU,Tom Nissalke,82,47,35,2,0,2,1,3,0
1979,IND,Slick Leonard,82,38,44,0,0,0,1,11,0
1979,KCK,Cotton Fitzsimmons,82,48,34,5,1,4,1,1,1
1979,LAL,Jerry West,82,47,35,8,3,5,1,3,0
1979,MIL,Don Nelson,82,38,44,0,0,0,1,3,0
1979,NJN,Kevin Loughery,82,37,45,2,0,2,1,6,0
1979,NOJ,Elgin Baylor,82,26,56,0,0,0,1,4,0
1979,NYK,Willis Reed,14,6,8,0,0,0,1,2,0
1979,NYK,Red Holzman,68,25,43,0,0,0,2,11,0
1979,PHI,Billy Cunningham,82,47,35,9,5,4,1,2,0
1979,PHO,John MacLeod,82,50,32,15,9,6,1,6,0
1979,POR,Jack Ramsay,82,45,37,3,1,2,1,3,0
1979,SAS,Doug Moe,82,48,34,14,7,7,1,3,0
1979,SDC,Gene Shue,82,43,39,0,0,0,1,1,1
1979,SEA,Lenny Wilkens,82,52,30,17,12,5,1,5,0
1979,WSB,Dick Motta,82,54,28,19,9,10,1,3,0
1980,ATL,Hubie Brown,82,50,32,5,1,4,1,4,0
1980,BOS,Bill Fitch,82,61,21,9,5,4,1,1,1
1980,CHI,Jerry Sloan,82,30,52,0,0,0,1,1,1
1980,CLE,Stan Albeck,82,37,45,0,0,0,1,1,1
1980,DEN,Donnie Walsh,82,30,52,0,0,0,1,2,0
1980,DET,Dick Vitale,12,4,8,0,0,0,1,2,0
1980,DET,Richie Adubato,70,12,58,0,0,0,2,1,1
1980,GSW,Al Attles,61,18,43,0,0,0,1,11,0
1980,GSW,Johnny Bach,21,6,15,0,0,0,2,1,1
1980,HOU,Del Harris,82,41,41,7,2,5,1,1,1
1980,IND,Slick Leonard,82,37,45,0,0,0,1,12,0
1980,KCK,Cotton Fitzsimmons,82,47,35,3,1,2,1,2,0
1980,LAL,Jack McKinney,14,10,4,0,0,0,1,1,1
1980,LAL,Paul Westhead,68,50,18,16,12,4,2,1,1
1980,MIL,Don Nelson,82,49,33,7,3,4,1,4,0
1980,NJN,Kevin Loughery,82,34,48,0,0,0,1,7,0
1980,NYK,Red Holzman,82,39,43,0,0,0,1,12,0
1980,PHI,Billy Cunningham,82,59,23,18,12,6,1,3,0
1980,PHO,John MacLeod,82,55,27,8,3,5,1,7,0
1980,POR,Jack Ramsay,82,38,44,3,1,2,1,4,0
1980,SAS,Doug Moe,66,33,33,0,0,0,1,4,0
1980,SAS,Bob Bass,16,8,8,3,1,2,2,3,0
1980,SDC,Gene Shue,82,35,47,0,0,0,1,2,0
1980,SEA,Lenny Wilkens,82,56,26,15,7,8,1,6,0
1980,UTA,Tom Nissalke,82,24,58,0,0,0,1,1,1
1980,WSB,Dick Motta,82,39,43,2,0,2,1,4,0
1981,ATL,Hubie Brown,79,31,48,0,0,0,1,5,0
1981,ATL,Mike Fratello,3,0,3,0,0,0,2,1,1
1981,BOS,Bill Fitch,82,62,20,17,12,5,1,2,0
1981,CHI,Jerry Sloan,82,45,37,6,2,4,1,2,0
1981,CLE,Bill Musselman,71,25,46,0,0,0,1,1,1
1981,CLE,Don Delaney,11,3,8,0,0,0,2,1,1
1981,DAL,Dick Motta,82,15,67,0,0,0,1,1,1
1981,DEN,Donnie Walsh,31,11,20,0,0,0,1,3,0
1981,DEN,Doug Moe,51,26,25,0,0,0,2,1,1
1981,DET,Scotty Robertson,82,21,61,0,0,0,1,1,1
1981,GSW,Al Attles,82,39,43,0,0,0,1,12,0
1981,HOU,Del Harris,82,40,42,21,12,9,1,2,0
1981,IND,Jack McKinney,82,44,38,2,0,2,1,1,1
1981,KCK,Cotton Fitzsimmons,82,40,42,15,7,8,1,3,0
1981,LAL,Paul Westhead,82,54,28,3,1,2,1,2,0
1981,MIL,Don Nelson,82,60,22,7,3,4,1,5,0
1981,NJN,Kevin Loughery,35,12,23,0,0,0,1,8,0
1981,NJN,Bob MacKinnon,47,12,35,0,0,0,2,1,1
1981,NYK,Red Holzman,82,50,32,2,0,2,1,13,0
1981,PHI,Billy Cunningham,82,62,20,16,9,7,1,4,0
1981,PHO,John MacLeod,82,57,25,7,3,4,1,8,0
1981,POR,Jack Ramsay,82,45,37,3,1,2,1,5,0
1981,SAS,Stan Albeck,82,52,30,7,3,4,1,1,1
1981,SDC,Paul Silas,82,36,46,0,0,0,1,1,1
1981,SEA,Lenny Wilkens,82,34,48,0,0,0,1,7,0
1981,UTA,Tom Nissalke,82,28,54,0,0,0,1,2,0
1981,WSB,Gene Shue,82,39,43,0,0,0,1,8,0
1982,ATL,Kevin Loughery,82,42,40,2,0,2,1,1,1
1982,BOS,Bill Fitch,82,63,19,12,7,5,1,3,0
1982,CHI,Jerry Sloan,51,19,32,0,0,0,1,3,0
1982,CHI,Phil Johnson,1,0,1,0,0,0,2,1,1
1982,CHI,Rod Thorn,30,15,15,0,0,0,3,1,1
1982,CLE,Don Delaney,15,4,11,0,0,0,1,2,0
1982,CLE,Bob Kloppenburg,3,0,3,0,0,0,2,1,1
1982,CLE,Chuck Daly,41,9,32,0,0,0,3,1,1
1982,CLE,Bill Musselman,23,2,21,0,0,0,4,2,0
1982,DAL,Dick Motta,82,28,54,0,0,0,1,2,0
1982,DEN,Doug Moe,82,46,36,3,1,2,1,2,0
1982,DET,Scotty Robertson,82,39,43,0,0,0,1,2,0
1982,GSW,Al Attles,82,45,37,0,0,0,1,13,0
1982,HOU,Del Harris,82,46,36,3,1,2,1,3,0
1982,IND,Jack McKinney,82,35,47,0,0,0,1,2,0
1982,KCK,Cotton Fitzsimmons,82,30,52,0,0,0,1,4,0
1982,LAL,Paul Westhead,11,7,4,0,0,0,1,3,0
1982,LAL,Pat Riley,71,50,21,14,12,2,2,1,1
1982,MIL,Don Nelson,82,55,27,6,2,4,1,6,0
1982,NJN,Larry Brown,82,44,38,2,0,2,1,1,1
1982,NYK,Red Holzman,82,33,49,0,0,0,1,14,0
1982,PHI,Billy Cunningham,82,58,24,21,12,9,1,5,0
1982,PHO,John MacLeod,82,46,36,7,2,5,1,9,0
1982,POR,Jack Ramsay,82,42,40,0,0,0,1,6,0
1982,SAS,Stan Albeck,82,48,34,9,4,5,1,2,0
1982,SDC,Paul Silas,82,17,65,0,0,0,1,2,0
1982,SEA,Lenny Wilkens,82,52,30,8,3,5,1,8,0
1982,UTA,Tom Nissalke,20,8,12,0,0,0,1,3,0
1982,UTA,Frank Layden,62,17,45,0,0,0,2,1,1
1982,WSB,Gene Shue,82,43,39,7,3,4,1,9,0
1983,ATL,Kevin Loughery,82,43,39,3,1,2,1,2,0
1983,BOS,Bill Fitch,82,56,26,7,2,5,1,4,0
1983,CHI,Paul Westhead,82,28,54,0,0,0,1,1,1
1983,CLE,Tom Nissalke,82,23,59,0,0,0,1,1,1
1983,DAL,Dick Motta,82,38,44,0,0,0,1,3,0
1983,DEN,Doug Moe,82,45,37,8,3,5,1,3,0
1983,DET,Scotty Robertson,82,37,45,0,0,0,1,3,0
1983,GSW,Al Attles,82,30,52,0,0,0,1,14,0
1983,HOU,Del Harris,82,14,68,0,0,0,1,4,0
1983,IND,Jack McKinney,82,20,62,0,0,0,1,3,0
1983,KCK,Cotton Fitzsimmons,82,45,37,0,0,0,1,5,0
1983,LAL,Pat Riley,82,58,24,15,8,7,1,2,0
1983,MIL,Don Nelson,82,51,31,9,5,4,1,7,0
1983,NJN,Larry Brown,76,47,29,0,0,0,1,2,0
1983,NJN,Bill Blair,6,2,4,2,0,2,2,1,1
1983,NYK,Hubie Brown,82,44,38,6,2,4,1,1,1
1983,PHI,Billy Cunningham,82,65,17,13,12,1,1,6,0
1983,PHO,John MacLeod,82,53,29,3,1,2,1,10,0
1983,POR,Jack Ramsay,82,46,36,7,3,4,1,7,0
1983,SAS,Stan Albeck,82,53,29,11,6,5,1,3,0
1983,SDC,Paul Silas,82,25,57,0,0,0,1,3,0
1983,SEA,Lenny Wilkens,82,48,34,2,0,2,1,9,0
1983,UTA,Frank Layden,82,30,52,0,0,0,1,2,0
1983,WSB,Gene Shue,82,42,40,0,0,0,1,10,0
1984,ATL,Mike Fratello,82,40,42,5,2,3,1,2,0
1984,BOS,K.C. Jones,82,62,20,23,15,8,1,1,1
1984,CHI,Kevin Loughery,82,27,55,0,0,0,1,1,1
1984,CLE,Tom Nissalke,82,28,54,0,0,0,1,2,0
1984,DAL,Dick Motta,82,43,39,10,4,6,1,4,0
1984,DEN,Doug Moe,82,38,44,5,2,3,1,4,0
1984,DET,Chuck Daly,82,49,33,5,2,3,1,1,1
1984,GSW,Johnny Bach,82,37,45,0,0,0,1,2,0
1984,HOU,Bill Fitch,82,29,53,0,0,0,1,1,1
1984,IND,Jack McKinney,82,26,56,0,0,0,1,4,0
1984,KCK,Cotton Fitzsimmons,82,38,44,3,0,3,1,6,0
1984,LAL,Pat Riley,82,54,28,21,14,7,1,3,0
1984,MIL,Don Nelson,82,50,32,16,8,8,1,8,0
1984,NJN,Stan Albeck,82,45,37,11,5,6,1,1,1
1984,NYK,Hubie Brown,82,47,35,12,6,6,1,2,0
1984,PHI,Billy Cunningham,82,52,30,5,2,3,1,7,0
1984,PHO,John MacLeod,82,41,41,17,9,8,1,11,0
1984,POR,Jack Ramsay,82,48,34,5,2,3,1,8,0
1984,SAS,Morris McHone,31,11,20,0,0,0,1,1,1
1984,SAS,Bob Bass,51,26,25,0,0,0,2,4,0
1984,SDC,Jim Lynam,82,30,52,0,0,0,1,1,1
1984,SEA,Lenny Wilkens,82,42,40,5,2,3,1,10,0
1984,UTA,Frank Layden,82,45,37,11,5,6,1,3,0
1984,WSB,Gene Shue,82,35,47,4,1,3,1,11,0
1985,ATL,Mike Fratello,82,34,48,0,0,0,1,3,0
1985,BOS,K.C. Jones,82,63,19,21,13,8,1,2,0
1985,CHI,Kevin Loughery,82,38,44,4,1,3,1,2,0
1985,CLE,George Karl,82,36,46,4,1,3,1,1,1
1985,DAL,Dick Motta,82,44,38,4,1,3,1,5,0
1985,DEN,Doug Moe,82,52,30,15,8,7,1,5,0
1985,DET,Chuck Daly,82,46,36,9,5,4,1,2,0
1985,GSW,Johnny Bach,82,22,60,0,0,0,1,3,0
1985,HOU,Bill Fitch,82,48,34,5,2,3,1,2,0
1985,IND,George Irvine,82,22,60,0,0,0,1,1,1
1985,KCK,Jack McKinney,9,1,8,0,0,0,1,1,1
1985,KCK,Phil Johnson,73,30,43,0,0,0,2,6,0
1985,LAC,Jim Lynam,61,22,39,0,0,0,1,2,0
1985,LAC,Don Chaney,21,9,12,0,0,0,2,1,1
1985,LAL,Pat Riley,82,62,20,19,15,4,1,4,0
1985,MIL,Don Nelson,82,59,23,8,3,5,1,9,0
1985,NJN,Stan Albeck,82,42,40,3,0,3,1,2,0
1985,NYK,Hubie Brown,82,24,58,0,0,0,1,3,0
1985,PHI,Billy Cunningham,82,58,24,13,8,5,1,8,0
1985,PHO,John MacLeod,82,36,46,3,0,3,1,12,0
1985,POR,Jack Ramsay,82,42,40,9,4,5,1,9,0
1985,SAS,Cotton Fitzsimmons,82,41,41,5,2,3,1,1,1
1985,SEA,Lenny Wilkens,82,31,51,0,0,0,1,11,0
1985,UTA,Frank Layden,82,41,41,10,4,6,1,4,0
1985,WSB,Gene Shue,82,40,42,4,1,3,1,12,0
1986,ATL,Mike Fratello,82,50,32,9,4,5,1,4,0
1986,BOS,K.C. Jones,82,67,15,18,15,3,1,3,0
1986,CHI,Stan Albeck,82,30,52,3,0,3,1,1,1
1986,CLE,George Karl,67,25,42,0,0,0,1,2,0
1986,CLE,Gene Littles,15,4,11,0,0,0,2,1,1
1986,DAL,Dick Motta,82,44,38,10,5,5,1,6,0
1986,DEN,Doug Moe,82,47,35,10,5,5,1,6,0
1986,DET,Chuck Daly,82,46,36,4,1,3,1,3,0
1986,GSW,Johnny Bach,82,30,52,0,0,0,1,4,0
1986,HOU,Bill Fitch,82,51,31,20,13,7,1,3,0
1986,IND,George Irvine,82,26,56,0,0,0,1,2,0
1986,LAC,Don Chaney,82,32,50,0,0,0,1,2,0
1986,LAL,Pat Riley,82,62,20,14,8,6,1,5,0
1986,MIL,Don Nelson,82,57,25,14,7,7,1,10,0
1986,NJN,Dave Wohl,82,39,43,3,0,3,1,1,1
1986,NYK,Hubie Brown,82,23,59,0,0,0,1,4,0
1986,PHI,Matt Guokas,82,54,28,12,6,6,1,1,1
1986,PHO,John MacLeod,82,32,50,0,0,0,1,13,0
1986,POR,Jack Ramsay,82,40,42,4,1,3,1,10,0
1986,SAC,Phil Johnson,82,37,45,3,0,3,1,7,0
1986,SAS,Cotton Fitzsimmons,82,35,47,3,0,3,1,2,0
1986,SEA,Bernie Bickerstaff,82,31,51,0,0,0,1,1,1
1986,UTA,Frank Layden,82,42,40,4,1,3,1,5,0
1986,WSB,Gene Shue,69,32,37,0,0,0,1,13,0
1986,WSB,Kevin Loughery,13,7,6,5,2,3,2,1,1
1987,ATL,Mike Fratello,82,57,25,9,4,5,1,5,0
1987,BOS,K.C. Jones,82,59,23,23,13,10,1,4,0
1987,CHI,Doug Collins,82,40,42,3,0,3,1,1,1
1987,CLE,Lenny Wilkens,82,31,51,0,0,0,1,1,1
1987,DAL,Dick Motta,82,55,27,4,1,3,1,7,0
1987,DEN,Doug Moe,82,37,45,3,0,3,1,7,0
1987,DET,Chuck Daly,82,52,30,15,10,5,1,4,0
1987,GSW,George Karl,82,42,40,10,4,6,1,1,1
1987,HOU,Bill Fitch,82,42,40,10,5,5,1,4,0
1987,IND,Jack Ramsay,82,41,41,4,1,3,1,1,1
1987,LAC,Don Chaney,82,12,70,0,0,0,1,3,0
1987,LAL,Pat Riley,82,65,17,18,15,3,1,6,0
1987,MIL,Don Nelson,82,50,32,12,6,6,1,11,0
1987,NJN,Dave Wohl,82,24,58,0,0,0,1,2,0
1987,NYK,Hubie Brown,16,4,12,0,0,0,1,5,0
1987,NYK,Bob Hill,66,20,46,0,0,0,2,1,1
1987,PHI,Matt Guokas,82,45,37,5,2,3,1,2,0
1987,PHO,John MacLeod,56,22,34,0,0,0,1,14,0
1987,PHO,Dick Van Arsdale,26,14,12,0,0,0,2,1,1
1987,POR,Mike Schuler,82,49,33,4,1,3,1,1,1
1987,SAC,Phil Johnson,46,14,32,0,0,0,1,8,0
1987,SAC,Jerry Reynolds,36,15,21,0,0,0,2,1,1
1987,SAS,Bob Weiss,82,28,54,0,0,0,1,1,1
1987,SEA,Bernie Bickerstaff,82,39,43,14,7,7,1,2,0
1987,UTA,Frank Layden,82,44,38,5,2,3,1,6,0
1987,WSB,Kevin Loughery,82,42,40,3,0,3,1,2,0
1988,ATL,Mike Fratello,82,50,32,12,6,6,1,6,0
1988,BOS,K.C. Jones,82,57,25,17,9,8,1,5,0
1988,CHI,Doug Collins,82,50,32,10,4,6,1,2,0
1988,CLE,Lenny Wilkens,82,42,40,5,2,3,1,2,0
1988,DAL,John MacLeod,82,53,29,17,10,7,1,1,1
1988,DEN,Doug Moe,82,54,28,11,5,6,1,8,0
1988,DET,Chuck Daly,82,54,28,23,14,9,1,5,0
1988,GSW,George Karl,64,16,48,0,0,0,1,2,0
1988,GSW,Ed Gregory,18,4,14,0,0,0,2,1,1
1988,HOU,Bill Fitch,82,46,36,4,1,3,1,5,0
1988,IND,Jack Ramsay,82,38,44,0,0,0,1,2,0
1988,LAC,Gene Shue,82,17,65,0,0,0,1,3,0
1988,LAL,Pat Riley,82,62,20,24,15,9,1,7,0
1988,MIL,Del Harris,82,42,40,5,2,3,1,1,1
1988,NJN,Dave Wohl,15,2,13,0,0,0,1,3,0
1988,NJN,Bob MacKinnon,39,10,29,0,0,0,2,2,0
1988,NJN,Willis Reed,28,7,21,0,0,0,3,1,1
1988,NYK,Rick Pitino,82,38,44,4,1,3,1,1,1
1988,PHI,Matt Guokas,43,20,23,0,0,0,1,3,0
1988,PHI,Jim Lynam,39,16,23,0,0,0,2,1,1
1988,PHO,John Wetzel,82,28,54,0,0,0,1,1,1
1988,POR,Mike Schuler,82,53,29,4,1,3,1,2,0
1988,SAC,Bill Russell,58,17,41,0,0,0,1,1,1
1988,SAC,Jerry Reynolds,24,7,17,0,0,0,2,2,0
1988,SAS,Bob Weiss,82,31,51,3,0,3,1,2,0
1988,SEA,Bernie Bickerstaff,82,44,38,5,2,3,1,3,0
1988,UTA,Frank Layden,82,47,35,11,6,5,1,7,0
1988,WSB,Kevin Loughery,27,8,19,0,0,0,1,3,0
1988,WSB,Wes Unseld,55,30,25,5,2,3,2,1,1
1989,ATL,Mike Fratello,82,52,30,5,2,3,1,7,0
1989,BOS,Jimmy Rodgers,82,42,40,3,0,3,1,1,1
1989,CHH,Dick Harter,82,20,62,0,0,0,1,1,1
1989,CHI,Doug Collins,82,47,35,17,9,8,1,3,0
1989,CLE,Lenny Wilkens,82,57,25,5,2,3,1,3,0
1989,DAL,John MacLeod,82,38,44,0,0,0,1,2,0
1989,DEN,Doug Moe,82,44,38,3,0,3,1,9,0
1989,DET,Chuck Daly,82,63,19,17,15,2,1,6,0
1989,GSW,Don Nelson,82,43,39,8,4,4,1,1,1
1989,HOU,Don Chaney,82,45,37,4,1,3,1,1,1
1989,IND,Jack Ramsay,7,0,7,0,0,0,1,3,0
1989,IND,Mel Daniels,2,0,2,0,0,0,2,1,1
1989,IND,George Irvine,20,6,14,0,0,0,3,3,0
1989,IND,Dick Versace,53,22,31,0,0,0,4,1,1
1989,LAC,Gene Shue,38,10,28,0,0,0,1,4,0
1989,LAC,Don Casey,44,11,33,0,0,0,2,1,1
1989,LAL,Pat Riley,82,57,25,15,11,4,1,8,0
1989,MIA,Ron Rothstein,82,15,67,0,0,0,1,1,1
1989,MIL,Del Harris,82,49,33,9,3,6,1,2,0
1989,NJN,Willis Reed,82,26,56,0,0,0,1,2,0
1989,NYK,Rick Pitino,82,52,30,9,5,4,1,2,0
1989,PHI,Jim Lynam,82,46,36,3,0,3,1,2,0
1989,PHO,Cotton Fitzsimmons,82,55,27,12,7,5,1,3,0
1989,POR,Mike Schuler,47,25,22,0,0,0,1,3,0
1989,POR,Rick Adelman,35,14,21,3,0,3,2,1,1
1989,SAC,Jerry Reynolds,82,27,55,0,0,0,1,3,0
1989,SAS,Larry Brown,82,21,61,0,0,0,1,1,1
1989,SEA,Bernie Bickerstaff,82,47,35,8,3,5,1,4,0
1989,UTA,Frank Layden,17,11,6,0,0,0,1,8,0
1989,UTA,Jerry Sloan,65,40,25,3,0,3,2,1,1
1989,WSB,Wes Unseld,82,40,42,0,0,0,1,2,0
1990,ATL,Mike Fratello,82,41,41,0,0,0,1,8,0
1990,BOS,Jimmy Rodgers,82,52,30,5,2,3,1,2,0
1990,CHH,Dick Harter,40,8,32,0,0,0,1,2,0
1990,CHH,Gene Littles,42,11,31,0,0,0,2,1,1
1990,CHI,Phil Jackson,82,55,27,16,10,6,1,1,1
1990,CLE,Lenny Wilkens,82,42,40,5,2,3,1,4,0
1990,DAL,John MacLeod,11,5,6,0,0,0,1,3,0
1990,DAL,Richie Adubato,71,42,29,3,0,3,2,1,1
1990,DEN,Doug Moe,82,43,39,3,0,3,1,10,0
1990,DET,Chuck Daly,82,59,23,20,15,5,1,7,0
1990,GSW,Don Nelson,82,37,45,0,0,0,1,2,0
1990,HOU,Don Chaney,82,41,41,4,1,3,1,2,0
1990,IND,Dick Versace,82,42,40,3,0,3,1,2,0
1990,LAC,Don Casey,82,30,52,0,0,0,1,2,0
1990,LAL,Pat Riley,82,63,19,9,4,5,1,9,0
1990,MIA,Ron Rothstein,82,18,64,0,0,0,1,2,0
1990,MIL,Del Harris,82,44,38,4,1,3,1,3,0
1990,MIN,Bill Musselman,82,22,60,0,0,0,1,1,1
1990,NJN,Bill Fitch,82,17,65,0,0,0,1,1,1
1990,NYK,Stu Jackson,82,45,37,10,4,6,1,1,1
1990,ORL,Matt Guokas,82,18,64,0,0,0,1,1,1
1990,PHI,Jim Lynam,82,53,29,10,4,6,1,3,0
1990,PHO,Cotton Fitzsimmons,82,54,28,16,9,7,1,4,0
1990,POR,Rick Adelman,82,59,23,21,12,9,1,2,0
1990,SAC,Jerry Reynolds,28,7,21,0,0,0,1,4,0
1990,SAC,Dick Motta,54,16,38,0,0,0,2,1,1
1990,SAS,Larry Brown,82,56,26,10,6,4,1,2,0
1990,SEA,Bernie Bickerstaff,82,41,41,0,0,0,1,5,0
1990,UTA,Jerry Sloan,82,55,27,5,2,3,1,2,0
1990,WSB,Wes Unseld,82,31,51,0,0,0,1,3,0
1991,ATL,Bob Weiss,82,43,39,5,2,3,1,1,1
1991,BOS,Chris Ford,82,56,26,11,5,6,1,1,1
1991,CHH,Gene Littles,82,26,56,0,0,0,1,2,0
1991,CHI,Phil Jackson,82,61,21,17,15,2,1,2,0
1991,CLE,Lenny Wilkens,82,33,49,0,0,0,1,5,0
1991,DAL,Richie Adubato,82,28,54,0,0,0,1,2,0
1991,DEN,Paul Westhead,82,20,62,0,0,0,1,1,1
1991,DET,Chuck Daly,82,50,32,15,7,8,1,8,0
1991,GSW,Don Nelson,82,44,38,9,4,5,1,3,0
1991,HOU,Don Chaney,82,52,30,3,0,3,1,3,0
1991,IND,Dick Versace,25,9,16,0,0,0,1,3,0
1991,IND,Bob Hill,57,32,25,5,2,3,2,1,1
1991,LAC,Mike Schuler,82,31,51,0,0,0,1,1,1
1991,LAL,Mike Dunleavy,82,58,24,19,12,7,1,1,1
1991,MIA,Ron Rothstein,82,24,58,0,0,0,1,3,0
1991,MIL,Del Harris,82,48,34,3,0,3,1,4,0
1991,MIN,Bill Musselman,82,29,53,0,0,0,1,2,0
1991,NJN,Bill Fitch,82,26,56,0,0,0,1,2,0
1991,NYK,Stu Jackson,15,7,8,0,0,0,1,2,0
1991,NYK,John MacLeod,67,32,35,3,0,3,2,1,1
1991,ORL,Matt Guokas,82,31,51,0,0,0,1,2,0
1991,PHI,Jim Lynam,82,44,38,8,4,4,1,4,0
1991,PHO,Cotton Fitzsimmons,82,55,27,4,1,3,1,5,0
1991,POR,Rick Adelman,82,63,19,16,9,7,1,3,0
1991,SAC,Dick Motta,82,25,57,0,0,0,1,2,0
1991,SAS,Larry Brown,82,55,27,4,1,3,1,3,0
1991,SEA,K.C. Jones,82,41,41,5,2,3,1,1,1
1991,UTA,Jerry Sloan,82,54,28,9,4,5,1,3,0
1991,WSB,Wes Unseld,82,30,52,0,0,0,1,4,0
1992,ATL,Bob Weiss,82,38,44,0,0,0,1,2,0
1992,BOS,Chris Ford,82,51,31,10,6,4,1,2,0
1992,CHH,Allan Bristow,82,31,51,0,0,0,1,1,1
1992,CHI,Phil Jackson,82,67,15,22,15,7,1,3,0
1992,CLE,Lenny Wilkens,82,57,25,17,9,8,1,6,0
1992,DAL,Richie Adubato,82,22,60,0,0,0,1,3,0
1992,DEN,Paul Westhead,82,24,58,0,0,0,1,2,0
1992,DET,Chuck Daly,82,48,34,5,2,3,1,9,0
1992,GSW,Don Nelson,82,55,27,4,1,3,1,4,0
1992,HOU,Don Chaney,52,26,26,0,0,0,1,4,0
1992,HOU,Rudy Tomjanovich,30,16,14,0,0,0,2,1,1
1992,IND,Bob Hill,82,40,42,3,0,3,1,2,0
1992,LAC,Mike Schuler,45,21,24,0,0,0,1,2,0
1992,LAC,Mack Calvin,2,1,1,0,0,0,2,1,1
1992,LAC,Larry Brown,35,23,12,5,2,3,3,1,1
1992,LAL,Mike Dunleavy,82,43,39,4,1,3,1,2,0
1992,MIA,Kevin Loughery,82,38,44,3,0,3,1,1,1
1992,MIL,Del Harris,17,8,9,0,0,0,1,5,0
1992,MIL,Frank Hamblen,65,23,42,0,0,0,2,1,1
1992,MIN,Jimmy Rodgers,82,15,67,0,0,0,1,1,1
1992,NJN,Bill Fitch,82,40,42,4,1,3,1,3,0
1992,NYK,Pat Riley,82,51,31,12,6,6,1,1,1
1992,ORL,Matt Guokas,82,21,61,0,0,0,1,3,0
1992,PHI,Jim Lynam,82,35,47,0,0,0,1,5,0
1992,PHO,Cotton Fitzsimmons,82,53,29,8,4,4,1,6,0
1992,POR,Rick Adelman,82,57,25,21,13,8,1,4,0
1992,SAC,Dick Motta,25,7,18,0,0,0,1,3,0
1992,SAC,Rex Hughes,57,22,35,0,0,0,2,1,1
1992,SAS,Larry Brown,38,21,17,0,0,0,1,4,0
1992,SAS,Bob Bass,44,26,18,3,0,3,2,5,0
1992,SEA,K.C. Jones,36,18,18,0,0,0,1,2,0
1992,SEA,Bob Kloppenburg,4,2,2,0,0,0,2,1,1
1992,SEA,George Karl,42,27,15,9,4,5,3,1,1
1992,UTA,Jerry Sloan,82,55,27,16,9,7,1,4,0
1992,WSB,Wes Unseld,82,25,57,0,0,0,1,5,0
1993,ATL,Bob Weiss,82,43,39,3,0,3,1,3,0
1993,BOS,Chris Ford,82,48,34,4,1,3,1,3,0
1993,CHH,Allan Bristow,82,44,38,9,4,5,1,2,0
1993,CHI,Phil Jackson,82,57,25,19,15,4,1,4,0
1993,CLE,Lenny Wilkens,82,54,28,9,3,6,1,7,0
1993,DAL,Richie Adubato,29,2,27,0,0,0,1,4,0
1993,DAL,Gar Heard,53,9,44,0,0,0,2,1,1
1993,DEN,Dan Issel,82,36,46,0,0,0,1,1,1
1993,DET,Ron Rothstein,82,40,42,0,0,0,1,1,1
1993,GSW,Don Nelson,82,34,48,0,0,0,1,5,0
1993,HOU,Rudy Tomjanovich,82,55,27,12,6,6,1,2,0
1993,IND,Bob Hill,82,41,41,4,1,3,1,3,0
1993,LAC,Larry Brown,82,41,41,5,2,3,1,2,0
1993,LAL,Randy Pfund,82,39,43,5,2,3,1,1,1
1993,MIA,Kevin Loughery,82,36,46,0,0,0,1,2,0
1993,MIL,Mike Dunleavy,82,28,54,0,0,0,1,1,1
1993,MIN,Jimmy Rodgers,29,6,23,0,0,0,1,2,0
1993,MIN,Sidney Lowe,53,13,40,0,0,0,2,1,1
1993,NJN,Chuck Daly,82,43,39,5,2,3,1,1,1
1993,NYK,Pat Riley,82,60,22,15,9,6,1,2,0
1993,ORL,Matt Guokas,82,41,41,0,0,0,1,4,0
1993,PHI,Doug Moe,56,19,37,0,0,0,1,1,1
1993,PHI,Fred Carter,26,7,19,0,0,0,2,1,1
1993,PHO,Paul Westphal,82,62,20,24,13,11,1,1,1
1993,POR,Rick Adelman,82,51,31,4,1,3,1,5,0
1993,SAC,Garry St. Jean,82,25,57,0,0,0,1,1,1
1993,SAS,Jerry Tarkanian,20,9,11,0,0,0,1,1,1
1993,SAS,Rex Hughes,1,1,0,0,0,0,2,1,1
1993,SAS,John Lucas,61,39,22,10,5,5,3,1,1
1993,SEA,George Karl,82,55,27,19,10,9,1,2,0
1993,UTA,Jerry Sloan,82,47,35,5,2,3,1,5,0
1993,WSB,Wes Unseld,82,22,60,0,0,0,1,6,0
1994,ATL,Lenny Wilkens,82,57,25,11,5,6,1,1,1
1994,BOS,Chris Ford,82,32,50,0,0,0,1,4,0
1994,CHH,Allan Bristow,82,41,41,0,0,0,1,3,0
1994,CHI,Phil Jackson,82,55,27,10,6,4,1,5,0
1994,CLE,Mike Fratello,82,47,35,3,0,3,1,1,1
1994,DAL,Quinn Buckner,82,13,69,0,0,0,1,1,1
1994,DEN,Dan Issel,82,42,40,12,6,6,1,2,0
1994,DET,Don Chaney,82,20,62,0,0,0,1,1,1
1994,GSW,Don Nelson,82,50,32,3,0,3,1,6,0
1994,HOU,Rudy Tomjanovich,82,58,24,23,15,8,1,3,0
1994,IND,Larry Brown,82,47,35,16,10,6,1,1,1
1994,LAC,Bob Weiss,82,27,55,0,0,0,1,1,1
1994,LAL,Randy Pfund,64,27,37,0,0,0,1,2,0
1994,LAL,Bill Bertka,2,1,1,0,0,0,2,1,1
1994,LAL,Magic Johnson,16,5,11,0,0,0,3,1,1
1994,MIA,Kevin Loughery,82,42,40,5,2,3,1,3,0
1994,MIL,Mike Dunleavy,82,20,62,0,0,0,1,2,0
1994,MIN,Sidney Lowe,82,20,62,0,0,0,1,2,0
1994,NJN,Chuck Daly,82,45,37,4,1,3,1,2,0
1994,NYK,Pat Riley,82,57,25,25,14,11,1,3,0
1994,ORL,Brian Hill,82,50,32,3,0,3,1,1,1
1994,PHI,Fred Carter,82,25,57,0,0,0,1,2,0
1994,PHO,Paul Westphal,82,56,26,10,6,4,1,2,0
1994,POR,Rick Adelman,82,47,35,4,1,3,1,6,0
1994,SAC,Garry St. Jean,82,28,54,0,0,0,1,2,0
1994,SAS,John Lucas,82,55,27,4,1,3,1,2,0
1994,SEA,George Karl,82,63,19,5,2,3,1,3,0
1994,UTA,Jerry Sloan,82,53,29,16,8,8,1,6,0
1994,WSB,Wes Unseld,82,24,58,0,0,0,1,7,0
1995,ATL,Lenny Wilkens,82,42,40,3,0,3,1,2,0
1995,BOS,Chris Ford,82,35,47,4,1,3,1,5,0
1995,CHH,Allan Bristow,82,50,32,4,1,3,1,4,0
1995,CHI,Phil Jackson,82,47,35,10,5,5,1,6,0
1995,CLE,Mike Fratello,82,43,39,4,1,3,1,2,0
1995,DAL,Dick Motta,82,36,46,0,0,0,1,8,0
1995,DEN,Dan Issel,34,18,16,0,0,0,1,3,0
1995,DEN,Gene Littles,16,3,13,0,0,0,2,1,1
1995,DEN,Bernie Bickerstaff,32,20,12,3,0,3,3,1,1
1995,DET,Don Chaney,82,28,54,0,0,0,1,2,0
1995,GSW,Don Nelson,45,14,31,0,0,0,1,7,0
1995,GSW,Bob Lanier,37,12,25,0,0,0,2,1,1
1995,HOU,Rudy Tomjanovich,82,47,35,22,15,7,1,4,0
1995,IND,Larry Brown,82,52,30,17,10,7,1,2,0
1995,LAC,Bill Fitch,82,17,65,0,0,0,1,1,1
1995,LAL,Del Harris,82,48,34,10,5,5,1,1,1
1995,MIA,Kevin Loughery,46,17,29,0,0,0,1,4,0
1995,MIA,Alvin Gentry,36,15,21,0,0,0,2,1,1
1995,MIL,Mike Dunleavy,82,34,48,0,0,0,1,3,0
1995,MIN,Bill Blair,82,21,61,0,0,0,1,1,1
1995,NJN,Butch Beard,82,30,52,0,0,0,1,1,1
1995,NYK,Pat Riley,82,55,27,11,6,5,1,4,0
1995,ORL,Brian Hill,82,57,25,21,11,10,1,2,0
1995,PHI,John Lucas,82,24,58,0,0,0,1,1,1
1995,PHO,Paul Westphal,82,59,23,10,6,4,1,3,0
1995,POR,P.J. Carlesimo,82,44,38,3,0,3,1,1,1
1995,SAC,Garry St. Jean,82,39,43,0,0,0,1,3,0
1995,SAS,Bob Hill,82,62,20,15,9,6,1,1,1
1995,SEA,George Karl,82,57,25,4,1,3,1,4,0
1995,UTA,Jerry Sloan,82,60,22,5,2,3,1,7,0
1995,WSB,Jim Lynam,82,21,61,0,0,0,1,1,1
1996,ATL,Lenny Wilkens,82,46,36,10,4,6,1,3,0
1996,BOS,M.L. Carr,82,33,49,0,0,0,1,1,1
1996,CHH,Allan Bristow,82,41,41,0,0,0,1,5,0
1996,CHI,Phil Jackson,82,72,10,18,15,3,1,7,0
1996,CLE,Mike Fratello,82,47,35,3,0,3,1,3,0
1996,DAL,Dick Motta,82,26,56,0,0,0,1,9,0
1996,DEN,Bernie Bickerstaff,82,35,47,0,0,0,1,2,0
1996,DET,Doug Collins,82,46,36,3,0,3,1,1,1
1996,GSW,Rick Adelman,82,36,46,0,0,0,1,1,1
1996,HOU,Rudy Tomjanovich,82,48,34,8,3,5,1,5,0
1996,IND,Larry Brown,82,52,30,5,2,3,1,3,0
1996,LAC,Bill Fitch,82,29,53,0,0,0,1,2,0
1996,LAL,Del Harris,82,53,29,4,1,3,1,2,0
1996,MIA,Pat Riley,82,42,40,3,0,3,1,1,1
1996,MIL,Mike Dunleavy,82,25,57,0,0,0,1,4,0
1996,MIN,Bill Blair,20,6,14,0,0,0,1,2,0
1996,MIN,Flip Saunders,62,20,42,0,0,0,2,1,1
1996,NJN,Butch Beard,82,30,52,0,0,0,1,2,0
1996,NYK,Don Nelson,59,34,25,0,0,0,1,1,1
1996,NYK,Jeff Van Gundy,23,13,10,8,4,4,2,1,1
1996,ORL,Brian Hill,82,60,22,12,7,5,1,3,0
1996,PHI,John Lucas,82,18,64,0,0,0,1,2,0
1996,PHO,Paul Westphal,33,14,19,0,0,0,1,4,0
1996,PHO,Cotton Fitzsimmons,49,27,22,4,1,3,2,7,0
1996,POR,P.J. Carlesimo,82,44,38,5,2,3,1,2,0
1996,SAC,Garry St. Jean,82,39,43,4,1,3,1,4,0
1996,SAS,Bob Hill,82,59,23,10,5,5,1,2,0
1996,SEA,George Karl,82,64,18,21,13,8,1,5,0
1996,TOR,Brendan Malone,82,21,61,0,0,0,1,1,1
1996,UTA,Jerry Sloan,82,55,27,18,10,8,1,8,0
1996,VAN,Brian Winters,82,15,67,0,0,0,1,1,1
1996,WSB,Jim Lynam,82,39,43,0,0,0,1,2,0
1997,ATL,Lenny Wilkens,82,56,26,10,4,6,1,4,0
1997,BOS,M.L. Carr,82,15,67,0,0,0,1,2,0
1997,CHH,Dave Cowens,82,54,28,3,0,3,1,1,1
1997,CHI,Phil Jackson,82,69,13,19,15,4,1,8,0
1997,CLE,Mike Fratello,82,42,40,0,0,0,1,4,0
1997,DAL,Jim Cleamons,82,24,58,0,0,0,1,1,1
1997,DEN,Bernie Bickerstaff,13,4,9,0,0,0,1,3,0
1997,DEN,Dick Motta,69,17,52,0,0,0,2,1,1
1997,DET,Doug Collins,82,54,28,5,2,3,1,2,0
1997,GSW,Rick Adelman,82,30,52,0,0,0,1,2,0
1997,HOU,Rudy Tomjanovich,82,57,25,16,9,7,1,6,0
1997,IND,Larry Brown,82,39,43,0,0,0,1,4,0
1997,LAC,Bill Fitch,82,36,46,3,0,3,1,3,0
1997,LAL,Del Harris,82,56,26,9,4,5,1,3,0
1997,MIA,Pat Riley,82,61,21,17,8,9,1,2,0
1997,MIL,Chris Ford,82,33,49,0,0,0,1,1,1
1997,MIN,Flip Saunders,82,40,42,3,0,3,1,2,0
1997,NJN,John Calipari,82,26,56,0,0,0,1,1,1
1997,NYK,Jeff Van Gundy,82,57,25,10,6,4,1,2,0
1997,ORL,Brian Hill,49,24,25,0,0,0,1,4,0
1997,ORL,Richie Adubato,33,21,12,5,2,3,2,1,1
1997,PHI,Johnny Davis,82,22,60,0,0,0,1,1,1
1997,PHO,Cotton Fitzsimmons,8,0,8,0,0,0,1,8,0
1997,PHO,Danny Ainge,74,40,34,5,2,3,2,1,1
1997,POR,P.J. Carlesimo,82,49,33,4,1,3,1,3,0
1997,SAC,Garry St. Jean,67,28,39,0,0,0,1,5,0
1997,SAC,Eddie Jordan,15,6,9,0,0,0,2,1,1
1997,SAS,Bob Hill,18,3,15,0,0,0,1,3,0
1997,SAS,Gregg Popovich,64,17,47,0,0,0,2,1,1
1997,SEA,George Karl,82,57,25,12,6,6,1,6,0
1997,TOR,Darrell Walker,82,30,52,0,0,0,1,1,1
1997,UTA,Jerry Sloan,82,64,18,20,13,7,1,9,0
1997,VAN,Brian Winters,43,8,35,0,0,0,1,2,0
1997,VAN,Stu Jackson,39,6,33,0,0,0,2,1,1
1997,WSB,Jim Lynam,46,22,24,0,0,0,1,3,0
1997,WSB,Bob Staak,1,0,1,0,0,0,2,1,1
1997,WSB,Bernie Bickerstaff,35,22,13,3,0,3,3,1,1
1998,ATL,Lenny Wilkens,82,50,32,4,1,3,1,5,0
1998,BOS,Rick Pitino,82,36,46,0,0,0,1,1,1
1998,CHH,Dave Cowens,82,51,31,9,4,5,1,2,0
1998,CHI,Phil Jackson,82,62,20,21,15,6,1,9,0
1998,CLE,Mike Fratello,82,47,35,4,1,3,1,5,0
1998,DAL,Jim Cleamons,16,4,12,0,0,0,1,2,0
1998,DAL,Don Nelson,66,16,50,0,0,0,2,1,1
1998,DEN,Bill Hanzlik,82,11,71,0,0,0,1,1,1
1998,DET,Doug Collins,45,21,24,0,0,0,1,3,0
1998,DET,Alvin Gentry,37,16,21,0,0,0,2,1,1
1998,GSW,P.J. Carlesimo,82,19,63,0,0,0,1,1,1
1998,HOU,Rudy Tomjanovich,82,41,41,5,2,3,1,7,0
1998,IND,Larry Bird,82,58,24,16,10,6,1,1,1
1998,LAC,Bill Fitch,82,17,65,0,0,0,1,4,0
1998,LAL,Del Harris,82,61,21,13,7,6,1,4,0
1998,MIA,Pat Riley,82,55,27,5,2,3,1,3,0
1998,MIL,Chris Ford,82,36,46,0,0,0,1,2,0
1998,MIN,Flip Saunders,82,45,37,5,2,3,1,3,0
1998,NJN,John Calipari,82,43,39,3,0,3,1,2,0
1998,NYK,Jeff Van Gundy,82,43,39,10,4,6,1,3,0
1998,ORL,Chuck Daly,82,41,41,0,0,0,1,1,1
1998,PHI,Larry Brown,82,31,51,0,0,0,1,1,1
1998,PHO,Danny Ainge,82,56,26,4,1,3,1,2,0
1998,POR,Mike Dunleavy,82,46,36,4,1,3,1,1,1
1998,SAC,Eddie Jordan,82,27,55,0,0,0,1,2,0
1998,SAS,Gregg Popovich,82,56,26,9,4,5,1,2,0
1998,SEA,George Karl,82,61,21,10,4,6,1,7,0
1998,TOR,Darrell Walker,49,11,38,0,0,0,1,2,0
1998,TOR,Butch Carter,33,5,28,0,0,0,2,1,1
1998,UTA,Jerry Sloan,82,62,20,20,13,7,1,10,0
1998,VAN,Brian Hill,82,19,63,0,0,0,1,1,1
1998,WAS,Bernie Bickerstaff,82,42,40,0,0,0,1,2,0
1999,ATL,Lenny Wilkens,50,31,19,9,3,6,1,6,0
1999,BOS,Rick Pitino,50,19,31,0,0,0,1,2,0
1999,CHH,Dave Cowens,15,4,11,0,0,0,1,3,0
1999,CHH,Paul Silas,35,22,13,0,0,0,2,1,1
1999,CHI,Tim Floyd,50,13,37,0,0,0,1,1,1
1999,CLE,Mike Fratello,50,22,28,0,0,0,1,6,0
1999,DAL,Don Nelson,50,19,31,0,0,0,1,2,0
1999,DEN,Mike D'Antoni,50,14,36,0,0,0,1,1,1
1999,DET,Alvin Gentry,50,29,21,5,2,3,1,2,0
1999,GSW,P.J. Carlesimo,50,21,29,0,0,0,1,2,0
1999,HOU,Rudy Tomjanovich,50,31,19,4,1,3,1,8,0
1999,IND,Larry Bird,50,33,17,13,9,4,1,2,0
1999,LAC,Chris Ford,50,9,41,0,0,0,1,1,1
1999,LAL,Del Harris,12,6,6,0,0,0,1,5,0
1999,LAL,Bill Bertka,1,1,0,0,0,0,2,2,0
1999,LAL,Kurt Rambis,37,24,13,8,3,5,3,1,1
1999,MIA,Pat Riley,50,33,17,5,2,3,1,4,0
1999,MIL,George Karl,50,28,22,3,0,3,1,1,1
1999,MIN,Flip Saunders,50,25,25,4,1,3,1,4,0
1999,NJN,John Calipari,20,3,17,0,0,0,1,3,0
1999,NJN,Don Casey,30,13,17,0,0,0,2,1,1
1999,NYK,Jeff Van Gundy,50,27,23,20,12,8,1,4,0
1999,ORL,Chuck Daly,50,33,17,4,1,3,1,2,0
1999,PHI,Larry Brown,50,28,22,8,3,5,1,2,0
1999,PHO,Danny Ainge,50,27,23,3,0,3,1,3,0
1999,POR,Mike Dunleavy,50,35,15,13,7,6,1,2,0
1999,SAC,Rick Adelman,50,27,23,5,2,3,1,1,1
1999,SAS,Gregg Popovich,50,37,13,17,15,2,1,3,0
1999,SEA,Paul Westphal,50,25,25,0,0,0,1,1,1
1999,TOR,Butch Carter,50,23,27,0,0,0,1,2,0
1999,UTA,Jerry Sloan,50,37,13,11,5,6,1,11,0
1999,VAN,Brian Hill,50,8,42,0,0,0,1,2,0
1999,WAS,Bernie Bickerstaff,32,13,19,0,0,0,1,3,0
1999,WAS,Jim Brovelli,18,5,13,0,0,0,2,1,1
2000,ATL,Lenny Wilkens,82,28,54,0,0,0,1,7,0
2000,BOS,Rick Pitino,82,35,47,0,0,0,1,3,0
2000,CHH,Paul Silas,82,49,33,4,1,3,1,2,0
2000,CHI,Tim Floyd,82,17,65,0,0,0,1,2,0
2000,CLE,Randy Wittman,82,32,50,0,0,0,1,1,1
2000,DAL,Don Nelson,82,40,42,0,0,0,1,3,0
2000,DEN,Dan Issel,82,35,47,0,0,0,1,4,0
2000,DET,Alvin Gentry,58,28,30,0,0,0,1,3,0
2000,DET,George Irvine,24,14,10,3,0,3,2,1,1
2000,GSW,P.J. Carlesimo,27,6,21,0,0,0,1,3,0
2000,GSW,Garry St. Jean,55,13,42,0,0,0,2,1,1
2000,HOU,Rudy Tomjanovich,82,34,48,0,0,0,1,9,0
2000,IND,Larry Bird,82,56,26,23,13,10,1,3,0
2000,LAC,Chris Ford,45,11,34,0,0,0,1,2,0
2000,LAC,Jim Todd,37,4,33,0,0,0,2,1,1
2000,LAL,Phil Jackson,82,67,15,23,15,8,1,1,1
2000,MIA,Pat Riley,82,52,30,10,6,4,1,5,0
2000,MIL,George Karl,82,42,40,5,2,3,1,2,0
2000,MIN,Flip Saunders,82,50,32,4,1,3,1,5,0
2000,NJN,Don Casey,82,31,51,0,0,0,1,2,0
2000,NYK,Jeff Van Gundy,82,50,32,16,9,7,1,5,0
2000,ORL,Doc Rivers,82,41,41,0,0,0,1,1,1
2000,PHI,Larry Brown,82,49,33,10,5,5,1,3,0
2000,PHO,Danny Ainge,20,13,7,0,0,0,1,4,0
2000,PHO,Scott Skiles,62,40,22,9,4,5,2,1,1
2000,POR,Mike Dunleavy,82,59,23,16,10,6,1,3,0
2000,SAC,Rick Adelman,82,44,38,5,2,3,1,2,0
2000,SAS,Gregg Popovich,82,53,29,4,1,3,1,4,0
2000,SEA,Paul Westphal,82,45,37,5,2,3,1,2,0
2000,TOR,Butch Carter,82,45,37,3,0,3,1,3,0
2000,UTA,Jerry Sloan,82,55,27,10,4,6,1,12,0
2000,VAN,Brian Hill,22,4,18,0,0,0,1,3,0
2000,VAN,Lionel Hollins,60,18,42,0,0,0,2,1,1
2000,WAS,Gar Heard,44,14,30,0,0,0,1,1,1
2000,WAS,Darrell Walker,38,15,23,0,0,0,2,1,1
2001,ATL,Lon Kruger,82,25,57,0,0,0,1,1,1
2001,BOS,Rick Pitino,34,12,22,0,0,0,1,4,0
2001,BOS,Jim O'Brien,48,24,24,0,0,0,2,1,1
2001,CHH,Paul Silas,82,46,36,10,6,4,1,3,0
2001,CHI,Tim Floyd,82,15,67,0,0,0,1,3,0
2001,CLE,Randy Wittman,82,30,52,0,0,0,1,2,0
2001,DAL,Don Nelson,82,53,29,10,4,6,1,4,0
2001,DEN,Dan Issel,82,40,42,0,0,0,1,5,0
2001,DET,George Irvine,82,32,50,0,0,0,1,2,0
2001,GSW,Dave Cowens,82,17,65,0,0,0,1,1,1
2001,HOU,Rudy Tomjanovich,82,45,37,0,0,0,1,10,0
2001,IND,Isiah Thomas,82,41,41,4,1,3,1,1,1
2001,LAC,Alvin Gentry,82,31,51,0,0,0,1,1,1
2001,LAL,Phil Jackson,82,56,26,16,15,1,1,2,0
2001,MIA,Pat Riley,82,50,32,3,0,3,1,6,0
2001,MIL,George Karl,82,52,30,18,10,8,1,3,0
2001,MIN,Flip Saunders,82,47,35,4,1,3,1,6,0
2001,NJN,Byron Scott,82,26,56,0,0,0,1,1,1
2001,NYK,Jeff Van Gundy,82,48,34,5,2,3,1,6,0
2001,ORL,Doc Rivers,82,43,39,4,1,3,1,2,0
2001,PHI,Larry Brown,82,56,26,23,12,11,1,4,0
2001,PHO,Scott Skiles,82,51,31,4,1,3,1,2,0
2001,POR,Mike Dunleavy,82,50,32,3,0,3,1,4,0
2001,SAC,Rick Adelman,82,55,27,8,3,5,1,3,0
2001,SAS,Gregg Popovich,82,58,24,13,7,6,1,5,0
2001,SEA,Paul Westphal,15,6,9,0,0,0,1,3,0
2001,SEA,Nate McMillan,67,38,29,0,0,0,2,1,1
2001,TOR,Lenny Wilkens,82,47,35,12,6,6,1,1,1
2001,UTA,Jerry Sloan,82,53,29,5,2,3,1,13,0
2001,VAN,Sidney Lowe,82,23,59,0,0,0,1,1,1
2001,WAS,Leonard Hamilton,82,19,63,0,0,0,1,1,1
2002,ATL,Lon Kruger,82,33,49,0,0,0,1,2,0
2002,BOS,Jim O'Brien,82,49,33,16,9,7,1,2,0
2002,CHH,Paul Silas,82,44,38,9,4,5,1,4,0
2002,CHI,Tim Floyd,25,4,21,0,0,0,1,4,0
2002,CHI,Bill Berry,2,0,2,0,0,0,2,1,1
2002,CHI,Bill Cartwright,55,17,38,0,0,0,3,1,1
2002,CLE,John Lucas,82,29,53,0,0,0,1,1,1
2002,DAL,Don Nelson,82,57,25,8,4,4,1,5,0
2002,DEN,Dan Issel,26,9,17,0,0,0,1,6,0
2002,DEN,Mike Evans,56,18,38,0,0,0,2,1,1
2002,DET,Rick Carlisle,82,50,32,10,4,6,1,1,1
2002,GSW,Dave Cowens,23,8,15,0,0,0,1,2,0
2002,GSW,Brian Winters,59,13,46,0,0,0,2,1,1
2002,HOU,Rudy Tomjanovich,82,28,54,0,0,0,1,11,0
2002,IND,Isiah Thomas,82,42,40,5,2,3,1,2,0
2002,LAC,Alvin Gentry,82,39,43,0,0,0,1,2,0
2002,LAL,Phil Jackson,82,58,24,19,15,4,1,3,0
2002,MEM,Sidney Lowe,82,23,59,0,0,0,1,2,0
2002,MIA,Pat Riley,82,36,46,0,0,0,1,7,0
2002,MIL,George Karl,82,41,41,0,0,0,1,4,0
2002,MIN,Flip Saunders,82,50,32,3,0,3,1,7,0
2002,NJN,Byron Scott,82,52,30,20,11,9,1,2,0
2002,NYK,Jeff Van Gundy,19,10,9,0,0,0,1,7,0
2002,NYK,Don Chaney,63,20,43,0,0,0,2,1,1
2002,ORL,Doc Rivers,82,44,38,4,1,3,1,3,0
2002,PHI,Larry Brown,82,43,39,5,2,3,1,5,0
2002,PHO,Scott Skiles,51,25,26,0,0,0,1,3,0
2002,PHO,Frank Johnson,31,11,20,0,0,0,2,1,1
2002,POR,Maurice Cheeks,82,49,33,3,0,3,1,1,1
2002,SAC,Rick Adelman,82,61,21,16,10,6,1,4,0
2002,SAS,Gregg Popovich,82,58,24,10,4,6,1,6,0
2002,SEA,Nate McMillan,82,45,37,5,2,3,1,2,0
2002,TOR,Lenny Wilkens,82,42,40,5,2,3,1,2,0
2002,UTA,Jerry Sloan,82,44,38,4,1,3,1,14,0
2002,WAS,Doug Collins,82,37,45,0,0,0,1,1,1
2003,ATL,Lon Kruger,27,11,16,0,0,0,1,3,0
2003,ATL,Terry Stotts,55,24,31,0,0,0,2,1,1
2003,BOS,Jim O'Brien,82,44,38,10,4,6,1,3,0
2003,CHI,Bill Cartwright,82,30,52,0,0,0,1,2,0
2003,CLE,John Lucas,42,8,34,0,0,0,1,2,0
2003,CLE,Keith Smart,40,9,31,0,0,0,2,1,1
2003,DAL,Don Nelson,82,60,22,20,10,10,1,6,0
2003,DEN,Jeff Bzdelik,82,17,65,0,0,0,1,1,1
2003,DET,Rick Carlisle,82,50,32,17,8,9,1,2,0
2003,GSW,Eric Musselman,82,38,44,0,0,0,1,1,1
2003,HOU,Rudy Tomjanovich,82,43,39,0,0,0,1,12,0
2003,IND,Isiah Thomas,82,48,34,6,2,4,1,3,0
2003,LAC,Alvin Gentry,58,19,39,0,0,0,1,3,0
2003,LAC,Dennis Johnson,24,8,16,0,0,0,2,1,1
2003,LAL,Phil Jackson,82,50,32,12,6,6,1,4,0
2003,MEM,Sidney Lowe,8,0,8,0,0,0,1,3,0
2003,MEM,Hubie Brown,74,28,46,0,0,0,2,1,1
2003,MIA,Pat Riley,82,25,57,0,0,0,1,8,0
2003,MIL,George Karl,82,42,40,6,2,4,1,5,0
2003,MIN,Flip Saunders,82,51,31,6,2,4,1,8,0
2003,NJN,Byron Scott,82,49,33,20,14,6,1,3,0
2003,NOH,Paul Silas,82,47,35,6,2,4,1,1,1
2003,NYK,Don Chaney,82,37,45,0,0,0,1,2,0
2003,ORL,Doc Rivers,82,42,40,7,3,4,1,4,0
2003,PHI,Larry Brown,82,48,34,12,6,6,1,6,0
2003,PHO,Frank Johnson,82,44,38,6,2,4,1,2,0
2003,POR,Maurice Cheeks,82,50,32,7,3,4,1,2,0
2003,SAC,Rick Adelman,82,59,23,12,7,5,1,5,0
2003,SAS,Gregg Popovich,82,60,22,24,16,8,1,7,0
2003,SEA,Nate McMillan,82,40,42,0,0,0,1,3,0
2003,TOR,Lenny Wilkens,82,24,58,0,0,0,1,3,0
2003,UTA,Jerry Sloan,82,47,35,5,1,4,1,15,0
2003,WAS,Doug Collins,82,37,45,0,0,0,1,2,0
2004,ATL,Terry Stotts,82,28,54,0,0,0,1,2,0
2004,BOS,Jim O'Brien,46,22,24,0,0,0,1,4,0
2004,BOS,John Carroll,36,14,22,4,0,4,2,1,1
2004,CHI,Bill Cartwright,14,4,10,0,0,0,1,3,0
2004,CHI,Pete Myers,2,0,2,0,0,0,2,1,1
2004,CHI,Scott Skiles,66,19,47,0,0,0,3,1,1
2004,CLE,Paul Silas,82,35,47,0,0,0,1,1,1
2004,DAL,Don Nelson,82,52,30,5,1,4,1,7,0
2004,DEN,Jeff Bzdelik,82,43,39,5,1,4,1,2,0
2004,DET,Larry Brown,82,54,28,23,16,7,1,1,1
2004,GSW,Eric Musselman,82,37,45,0,0,0,1,2,0
2004,HOU,Jeff Van Gundy,82,45,37,5,1,4,1,1,1
2004,IND,Rick Carlisle,82,61,21,16,10,6,1,1,1
2004,LAC,Mike Dunleavy,82,28,54,0,0,0,1,1,1
2004,LAL,Phil Jackson,82,56,26,22,13,9,1,5,0
2004,MEM,Hubie Brown,82,50,32,4,0,4,1,2,0
2004,MIA,Stan Van Gundy,82,42,40,13,6,7,1,1,1
2004,MIL,Terry Porter,82,41,41,5,1,4,1,1,1
2004,MIN,Flip Saunders,82,58,24,18,10,8,1,9,0
2004,NJN,Byron Scott,42,22,20,0,0,0,1,4,0
2004,NJN,Lawrence Frank,40,25,15,11,7,4,2,1,1
2004,NOH,Tim Floyd,82,41,41,7,3,4,1,1,1
2004,NYK,Don Chaney,39,15,24,0,0,0,1,3,0
2004,NYK,Herb Williams,1,1,0,0,0,0,2,1,1
2004,NYK,Lenny Wilkens,42,23,19,4,0,4,3,1,1
2004,ORL,Doc Rivers,11,1,10,0,0,0,1,5,0
2004,ORL,Johnny Davis,71,20,51,0,0,0,2,1,1
2004,PHI,Randy Ayers,52,21,31,0,0,0,1,1,1
2004,PHI,Chris Ford,30,12,18,0,0,0,2,1,1
2004,PHO,Frank Johnson,21,8,13,0,0,0,1,3,0
2004,PHO,Mike D'Antoni,61,21,40,0,0,0,2,1,1
2004,POR,Maurice Cheeks,82,41,41,0,0,0,1,3,0
2004,SAC,Rick Adelman,82,55,27,12,7,5,1,6,0
2004,SAS,Gregg Popovich,82,57,25,10,6,4,1,8,0
2004,SEA,Nate McMillan,82,37,45,0,0,0,1,4,0
2004,TOR,Kevin O'Neill,82,33,49,0,0,0,1,1,1
2004,UTA,Jerry Sloan,82,42,40,0,0,0,1,16,0
2004,WAS,Eddie Jordan,82,25,57,0,0,0,1,1,1
2005,ATL,Mike Woodson,82,13,69,0,0,0,1,1,1
2005,BOS,Doc Rivers,82,45,37,7,3,4,1,1,1
2005,CHA,Bernie Bickerstaff,82,18,64,0,0,0,1,1,1
2005,CHI,Scott Skiles,82,47,35,6,2,4,1,2,0
2005,CLE,Paul Silas,64,34,30,0,0,0,1,2,0
2005,CLE,Brendan Malone,18,8,10,0,0,0,2,1,1
2005,DAL,Don Nelson,64,42,22,0,0,0,1,8,0
2005,DAL,Avery Johnson,18,16,2,13,6,7,2,1,1
2005,DEN,Jeff Bzdelik,28,13,15,0,0,0,1,3,0
2005,DEN,Michael Cooper,14,4,10,0,0,0,2,1,1
2005,DEN,George Karl,40,32,8,5,1,4,3,1,1
2005,DET,Larry Brown,82,54,28,25,15,10,1,2,0
2005,GSW,Mike Montgomery,82,34,48,0,0,0,1,1,1
2005,HOU,Jeff Van Gundy,82,51,31,7,3,4,1,2,0
2005,IND,Rick Carlisle,82,44,38,13,6,7,1,2,0
2005,LAC,Mike Dunleavy,82,37,45,0,0,0,1,2,0
2005,LAL,Rudy Tomjanovich,43,24,19,0,0,0,1,1,1
2005,LAL,Frank Hamblen,39,10,29,0,0,0,2,1,1
2005,MEM,Hubie Brown,12,5,7,0,0,0,1,3,0
2005,MEM,Lionel Hollins,4,0,4,0,0,0,2,2,0
2005,MEM,Mike Fratello,66,40,26,4,0,4,3,1,1
2005,MIA,Stan Van Gundy,82,59,23,15,11,4,1,2,0
2005,MIL,Terry Porter,82,30,52,0,0,0,1,2,0
2005,MIN,Flip Saunders,51,25,26,0,0,0,1,10,0
2005,MIN,Kevin McHale,31,19,12,0,0,0,2,1,1
2005,NJN,Lawrence Frank,82,42,40,4,0,4,1,2,0
2005,NOH,Byron Scott,82,18,64,0,0,0,1,1,1
2005,NYK,Lenny Wilkens,39,17,22,0,0,0,1,2,0
2005,NYK,Herb Williams,43,16,27,0,0,0,2,2,0
2005,ORL,Johnny Davis,64,31,33,0,0,0,1,2,0
2005,ORL,Chris Jent,18,5,13,0,0,0,2,1,1
2005,PHI,Jim O'Brien,82,43,39,5,1,4,1,1,1
2005,PHO,Mike D'Antoni,82,62,20,15,9,6,1,2,0
2005,POR,Maurice Cheeks,55,22,33,0,0,0,1,4,0
2005,POR,Kevin Pritchard,27,5,22,0,0,0,2,1,1
2005,SAC,Rick Adelman,82,50,32,5,1,4,1,7,0
2005,SAS,Gregg Popovich,82,59,23,23,16,7,1,9,0
2005,SEA,Nate McMillan,82,52,30,11,6,5,1,5,0
2005,TOR,Sam Mitchell,82,33,49,0,0,0,1,1,1
2005,UTA,Jerry Sloan,82,26,56,0,0,0,1,17,0
2005,WAS,Eddie Jordan,82,45,37,10,4,6,1,2,0
2006,ATL,Mike Woodson,82,26,56,0,0,0,1,2,0
2006,BOS,Doc Rivers,82,33,49,0,0,0,1,2,0
2006,CHA,Bernie Bickerstaff,82,26,56,0,0,0,1,2,0
2006,CHI,Scott Skiles,82,41,41,6,2,4,1,3,0
2006,CLE,Mike Brown,82,50,32,13,7,6,1,1,1
2006,DAL,Avery Johnson,82,60,22,23,14,9,1,2,0
2006,DEN,George Karl,82,44,38,5,1,4,1,2,0
2006,DET,Flip Saunders,82,64,18,18,10,8,1,1,1
2006,GSW,Mike Montgomery,82,34,48,0,0,0,1,2,0
2006,HOU,Jeff Van Gundy,82,34,48,0,0,0,1,3,0
2006,IND,Rick Carlisle,82,41,41,6,2,4,1,3,0
2006,LAC,Mike Dunleavy,82,47,35,12,7,5,1,3,0
2006,LAL,Phil Jackson,82,45,37,7,3,4,1,6,0
2006,MEM,Mike Fratello,82,49,33,4,0,4,1,2,0
2006,MIA,Stan Van Gundy,21,11,10,0,0,0,1,3,0
2006,MIA,Pat Riley,61,41,20,23,16,7,2,9,0
2006,MIL,Terry Stotts,82,40,42,5,1,4,1,1,1
2006,MIN,Dwane Casey,82,33,49,0,0,0,1,1,1
2006,NJN,Lawrence Frank,82,49,33,11,5,6,1,3,0
2006,NOK,Byron Scott,82,38,44,0,0,0,1,2,0
2006,NYK,Larry Brown,82,23,59,0,0,0,1,1,1
2006,ORL,Brian Hill,82,36,46,0,0,0,1,5,0
2006,PHI,Maurice Cheeks,82,38,44,0,0,0,1,1,1
2006,PHO,Mike D'Antoni,82,54,28,20,10,10,1,3,0
2006,POR,Nate McMillan,82,21,61,0,0,0,1,1,1
2006,SAC,Rick Adelman,82,44,38,6,2,4,1,8,0
2006,SAS,Gregg Popovich,82,63,19,13,7,6,1,10,0
2006,SEA,Bob Weiss,30,13,17,0,0,0,1,1,1
2006,SEA,Bob Hill,52,22,30,0,0,0,2,1,1
2006,TOR,Sam Mitchell,82,27,55,0,0,0,1,2,0
2006,UTA,Jerry Sloan,82,41,41,0,0,0,1,18,0
2006,WAS,Eddie Jordan,82,42,40,6,2,4,1,3,0
2007,ATL,Mike Woodson,82,30,52,0,0,0,1,3,0
2007,BOS,Doc Rivers,82,24,58,0,0,0,1,3,0
2007,CHA,Bernie Bickerstaff,82,33,49,0,0,0,1,3,0
2007,CHI,Scott Skiles,82,49,33,10,6,4,1,4,0
2007,CLE,Mike Brown,82,50,32,20,12,8,1,2,0
2007,DAL,Avery Johnson,82,67,15,6,2,4,1,3,0
2007,DEN,George Karl,82,45,37,5,1,4,1,3,0
2007,DET,Flip Saunders,82,53,29,16,10,6,1,2,0
2007,GSW,Don Nelson,82,42,40,11,5,6,1,8,0
2007,HOU,Jeff Van Gundy,82,52,30,7,3,4,1,4,0
2007,IND,Rick Carlisle,82,35,47,0,0,0,1,4,0
2007,LAC,Mike Dunleavy,82,40,42,0,0,0,1,4,0
2007,LAL,Phil Jackson,82,42,40,5,1,4,1,7,0
2007,MEM,Mike Fratello,30,6,24,0,0,0,1,3,0
2007,MEM,Tony Barone,52,16,36,0,0,0,2,1,1
2007,MIA,Pat Riley,82,44,38,4,0,4,1,10,0
2007,MIL,Terry Stotts,64,23,41,0,0,0,1,2,0
2007,MIL,Larry Krystkowiak,18,5,13,0,0,0,2,1,1
2007,MIN,Dwane Casey,40,20,20,0,0,0,1,2,0
2007,MIN,Randy Wittman,42,12,30,0,0,0,2,1,1
2007,NJN,Lawrence Frank,82,41,41,12,6,6,1,4,0
2007,NOK,Byron Scott,82,39,43,0,0,0,1,3,0
2007,NYK,Isiah Thomas,82,33,49,0,0,0,1,1,1
2007,ORL,Brian Hill,82,40,42,4,0,4,1,6,0
2007,PHI,Maurice Cheeks,82,35,47,0,0,0,1,2,0
2007,PHO,Mike D'Antoni,82,61,21,11,6,5,1,4,0
2007,POR,Nate McMillan,82,32,50,0,0,0,1,2,0
2007,SAC,Eric Musselman,82,33,49,0,0,0,1,1,1
2007,SAS,Gregg Popovich,82,58,24,20,16,4,1,11,0
2007,SEA,Bob Hill,82,31,51,0,0,0,1,2,0
2007,TOR,Sam Mitchell,82,47,35,6,2,4,1,3,0
2007,UTA,Jerry Sloan,82,51,31,17,9,8,1,19,0
2007,WAS,Eddie Jordan,82,41,41,4,0,4,1,4,0
2008,ATL,Mike Woodson,82,37,45,7,3,4,1,4,0
2008,BOS,Doc Rivers,82,66,16,26,16,10,1,4,0
2008,CHA,Sam Vincent,82,32,50,0,0,0,1,1,1
2008,CHI,Scott Skiles,25,9,16,0,0,0,1,5,0
2008,CHI,Pete Myers,1,0,1,0,0,0,2,2,0
2008,CHI,Jim Boylan,56,24,32,0,0,0,3,1,1
2008,CLE,Mike Brown,82,45,37,13,7,6,1,3,0
2008,DAL,Avery Johnson,82,51,31,5,1,4,1,4,0
2008,DEN,George Karl,82,50,32,4,0,4,1,4,0
2008,DET,Flip Saunders,82,59,23,17,10,7,1,3,0
2008,GSW,Don Nelson,82,48,34,0,0,0,1,9,0
2008,HOU,Rick Adelman,82,55,27,6,2,4,1,1,1
2008,IND,Jim O'Brien,82,36,46,0,0,0,1,1,1
2008,LAC,Mike Dunleavy,82,23,59,0,0,0,1,5,0
2008,LAL,Phil Jackson,82,57,25,21,14,7,1,8,0
2008,MEM,Marc Iavaroni,82,22,60,0,0,0,1,1,1
2008,MIA,Pat Riley,82,15,67,0,0,0,1,11,0
2008,MIL,Larry Krystkowiak,82,26,56,0,0,0,1,2,0
2008,MIN,Randy Wittman,82,22,60,0,0,0,1,2,0
2008,NJN,Lawrence Frank,82,34,48,0,0,0,1,5,0
2008,NOH,Byron Scott,82,56,26,12,7,5,1,4,0
2008,NYK,Isiah Thomas,82,23,59,0,0,0,1,2,0
2008,ORL,Stan Van Gundy,82,52,30,10,5,5,1,1,1
2008,PHI,Maurice Cheeks,82,40,42,6,2,4,1,3,0
2008,PHO,Mike D'Antoni,82,55,27,5,1,4,1,5,0
2008,POR,Nate McMillan,82,41,41,0,0,0,1,3,0
2008,SAC,Reggie Theus,82,38,44,0,0,0,1,1,1
2008,SAS,Gregg Popovich,82,56,26,17,9,8,1,12,0
2008,SEA,P.J. Carlesimo,82,20,62,0,0,0,1,1,1
2008,TOR,Sam Mitchell,82,41,41,5,1,4,1,4,0
2008,UTA,Jerry Sloan,82,54,28,12,6,6,1,20,0
2008,WAS,Eddie Jordan,82,43,39,6,2,4,1,5,0
2009,ATL,Mike Woodson,82,47,35,11,4,7,1,5,0
2009,BOS,Doc Rivers,82,62,20,14,7,7,1,5,0
2009,CHA,Larry Brown,82,35,47,0,0,0,1,1,1
2009,CHI,Vinny Del Negro,82,41,41,7,3,4,1,1,1
2009,CLE,Mike Brown,82,66,16,14,10,4,1,4,0
2009,DAL,Rick Carlisle,82,50,32,10,5,5,1,1,1
2009,DEN,George Karl,82,54,28,16,10,6,1,5,0
2009,DET,Michael Curry,82,39,43,4,0,4,1,1,1
2009,GSW,Don Nelson,82,29,53,0,0,0,1,10,0
2009,HOU,Rick Adelman,82,53,29,13,7,6,1,2,0
2009,IND,Jim O'Brien,82,36,46,0,0,0,1,2,0
2009,LAC,Mike Dunleavy,82,19,63,0,0,0,1,6,0
2009,LAL,Phil Jackson,82,65,17,23,16,7,1,9,0
2009,MEM,Marc Iavaroni,41,11,30,0,0,0,1,2,0
2009,MEM,Johnny Davis,2,0,2,0,0,0,2,1,1
2009,MEM,Lionel Hollins,39,13,26,0,0,0,3,3,0
2009,MIA,Erik Spoelstra,82,43,39,7,3,4,1,1,1
2009,MIL,Scott Skiles,82,34,48,0,0,0,1,1,1
2009,MIN,Randy Wittman,19,4,15,0,0,0,1,3,0
2009,MIN,Kevin McHale,63,20,43,0,0,0,2,2,0
2009,NJN,Lawrence Frank,82,34,48,0,0,0,1,6,0
2009,NOH,Byron Scott,82,49,33,5,1,4,1,5,0
2009,NYK,Mike D'Antoni,82,32,50,0,0,0,1,1,1
2009,OKC,P.J. Carlesimo,13,1,12,0,0,0,1,2,0
2009,OKC,Scott Brooks,69,22,47,0,0,0,2,1,1
2009,ORL,Stan Van Gundy,82,59,23,24,13,11,1,2,0
2009,PHI,Maurice Cheeks,23,9,14,0,0,0,1,4,0
2009,PHI,Tony DiLeo,59,32,27,6,2,4,2,1,1
2009,PHO,Terry Porter,51,28,23,0,0,0,1,1,1
2009,PHO,Alvin Gentry,31,18,13,0,0,0,2,1,1
2009,POR,Nate McMillan,82,54,28,6,2,4,1,4,0
2009,SAC,Reggie Theus,24,6,18,0,0,0,1,2,0
2009,SAC,Kenny Natt,58,11,47,0,0,0,2,1,1
2009,SAS,Gregg Popovich,82,54,28,5,1,4,1,13,0
2009,TOR,Sam Mitchell,17,8,9,0,0,0,1,5,0
2009,TOR,Jay Triano,65,25,40,0,0,0,2,1,1
2009,UTA,Jerry Sloan,82,48,34,5,1,4,1,21,0
2009,WAS,Eddie Jordan,11,1,10,0,0,0,1,6,0
2009,WAS,Ed Tapscott,71,18,53,0,0,0,2,1,1
2010,ATL,Mike Woodson,82,53,29,11,4,7,1,6,0
2010,BOS,Doc Rivers,82,50,32,24,15,9,1,6,0
2010,CHA,Larry Brown,82,44,38,4,0,4,1,2,0
2010,CHI,Vinny Del Negro,82,41,41,5,1,4,1,2,0
2010,CLE,Mike Brown,82,61,21,11,6,5,1,5,0
2010,DAL,Rick Carlisle,82,55,27,6,2,4,1,2,0
2010,DEN,George Karl,82,53,29,6,2,4,1,6,0
2010,DET,John Kuester,82,27,55,0,0,0,1,1,1
2010,GSW,Don Nelson,82,26,56,0,0,0,1,11,0
2010,HOU,Rick Adelman,82,42,40,0,0,0,1,3,0
2010,IND,Jim O'Brien,82,32,50,0,0,0,1,3,0
2010,LAC,Mike Dunleavy,49,21,28,0,0,0,1,7,0
2010,LAC,Kim Hughes,33,8,25,0,0,0,2,1,1
2010,LAL,Phil Jackson,82,57,25,23,16,7,1,10,0
2010,MEM,Lionel Hollins,82,40,42,0,0,0,1,4,0
2010,MIA,Erik Spoelstra,82,47,35,5,1,4,1,2,0
2010,MIL,Scott Skiles,82,46,36,7,3,4,1,2,0
2010,MIN,Kurt Rambis,82,15,67,0,0,0,1,1,1
2010,NJN,Lawrence Frank,16,0,16,0,0,0,1,7,0
2010,NJN,Tom Barrise,2,0,2,0,0,0,2,1,1
2010,NJN,Kiki Vandeweghe,64,12,52,0,0,0,3,1,1
2010,NOH,Byron Scott,9,3,6,0,0,0,1,6,0
2010,NOH,Jeff Bower,73,34,39,0,0,0,2,1,1
2010,NYK,Mike D'Antoni,82,29,53,0,0,0,1,2,0
2010,OKC,Scott Brooks,82,50,32,6,2,4,1,2,0
2010,ORL,Stan Van Gundy,82,59,23,14,10,4,1,3,0
2010,PHI,Eddie Jordan,82,27,55,0,0,0,1,1,1
2010,PHO,Alvin Gentry,82,54,28,16,10,6,1,2,0
2010,POR,Nate McMillan,82,50,32,6,2,4,1,5,0
2010,SAC,Paul Westphal,82,25,57,0,0,0,1,1,1
2010,SAS,Gregg Popovich,82,50,32,10,4,6,1,14,0
2010,TOR,Jay Triano,82,40,42,0,0,0,1,2,0
2010,UTA,Jerry Sloan,82,53,29,10,4,6,1,22,0
2010,WAS,Flip Saunders,82,26,56,0,0,0,1,1,1
2011,ATL,Larry Drew,82,44,38,12,6,6,1,1,1
2011,BOS,Doc Rivers,82,56,26,9,5,4,1,7,0
2011,CHA,Larry Brown,28,9,19,0,0,0,1,3,0
2011,CHA,Paul Silas,54,25,29,0,0,0,2,5,0
2011,CHI,Tom Thibodeau,82,62,20,16,9,7,1,1,1
2011,CLE,Byron Scott,82,19,63,0,0,0,1,1,1
2011,DAL,Rick Carlisle,82,57,25,21,16,5,1,3,0
2011,DEN,George Karl,82,50,32,5,1,4,1,7,0
2011,DET,John Kuester,82,30,52,0,0,0,1,2,0
2011,GSW,Keith Smart,82,36,46,0,0,0,1,1,1
2011,HOU,Rick Adelman,82,43,39,0,0,0,1,4,0
2011,IND,Jim O'Brien,44,17,27,0,0,0,1,4,0
2011,IND,Frank Vogel,38,20,18,5,1,4,2,1,1
2011,LAC,Vinny Del Negro,82,32,50,0,0,0,1,1,1
2011,LAL,Phil Jackson,82,57,25,10,4,6,1,11,0
2011,MEM,Lionel Hollins,82,46,36,13,7,6,1,5,0
2011,MIA,Erik Spoelstra,82,58,24,21,14,7,1,3,0
2011,MIL,Scott Skiles,82,35,47,0,0,0,1,3,0
2011,MIN,Kurt Rambis,82,17,65,0,0,0,1,2,0
2011,NJN,Avery Johnson,82,24,58,0,0,0,1,1,1
2011,NOH,Monty Williams,82,46,36,6,2,4,1,1,1
2011,NYK,Mike D'Antoni,82,42,40,4,0,4,1,3,0
2011,OKC,Scott Brooks,82,55,27,17,9,8,1,3,0
2011,ORL,Stan Van Gundy,82,52,30,6,2,4,1,4,0
2011,PHI,Doug Collins,82,41,41,5,1,4,1,1,1
2011,PHO,Alvin Gentry,82,40,42,0,0,0,1,3,0
2011,POR,Nate McMillan,82,48,34,6,2,4,1,6,0
2011,SAC,Paul Westphal,82,24,58,0,0,0,1,2,0
2011,SAS,Gregg Popovich,82,61,21,6,2,4,1,15,0
2011,TOR,Jay Triano,82,22,60,0,0,0,1,3,0
2011,UTA,Jerry Sloan,54,31,23,0,0,0,1,23,0
2011,UTA,Tyrone Corbin,28,8,20,0,0,0,2,1,1
2011,WAS,Flip Saunders,82,23,59,0,0,0,1,2,0
2012,ATL,Larry Drew,66,40,26,6,2,4,1,2,0
2012,BOS,Doc Rivers,66,39,27,20,11,9,1,8,0
2012,CHA,Paul Silas,66,7,59,0,0,0,1,6,0
2012,CHI,Tom Thibodeau,66,50,16,6,2,4,1,2,0
2012,CLE,Byron Scott,66,21,45,0,0,0,1,2,0
2012,DAL,Rick Carlisle,66,36,30,4,0,4,1,4,0
2012,DEN,George Karl,66,38,28,7,3,4,1,8,0
2012,DET,Lawrence Frank,66,25,41,0,0,0,1,1,1
2012,GSW,Mark Jackson,66,23,43,0,0,0,1,1,1
2012,HOU,Kevin McHale,66,34,32,0,0,0,1,1,1
2012,IND,Frank Vogel,66,42,24,11,6,5,1,2,0
2012,LAC,Vinny Del Negro,66,40,26,11,4,7,1,2,0
2012,LAL,Mike Brown,66,41,25,12,5,7,1,1,1
2012,MEM,Lionel Hollins,66,41,25,7,3,4,1,6,0
2012,MIA,Erik Spoelstra,66,46,20,23,16,7,1,4,0
2012,MIL,Scott Skiles,66,31,35,0,0,0,1,4,0
2012,MIN,Rick Adelman,66,26,40,0,0,0,1,1,1
2012,NJN,Avery Johnson,66,22,44,0,0,0,1,2,0
2012,NOH,Monty Williams,66,21,45,0,0,0,1,2,0
2012,NYK,Mike D'Antoni,42,18,24,0,0,0,1,4,0
2012,NYK,Mike Woodson,24,18,6,5,1,4,2,1,1
2012,OKC,Scott Brooks,66,47,19,20,13,7,1,4,0
2012,ORL,Stan Van Gundy,66,37,29,5,1,4,1,5,0
2012,PHI,Doug Collins,66,35,31,13,7,6,1,2,0
2012,PHO,Alvin Gentry,66,33,33,0,0,0,1,4,0
2012,POR,Nate McMillan,43,20,23,0,0,0,1,7,0
2012,POR,Kaleb Canales,23,8,15,0,0,0,2,1,1
2012,SAC,Paul Westphal,7,2,5,0,0,0,1,3,0
2012,SAC,Keith Smart,59,20,39,0,0,0,2,1,1
2012,SAS,Gregg Popovich,66,50,16,14,10,4,1,16,0
2012,TOR,Dwane Casey,66,23,43,0,0,0,1,1,1
2012,UTA,Tyrone Corbin,66,36,30,4,0,4,1,2,0
2012,WAS,Flip Saunders,17,2,15,0,0,0,1,3,0
2012,WAS,Randy Wittman,49,18,31,0,0,0,2,1,1
2013,ATL,Larry Drew,82,44,38,6,2,4,1,3,0
2013,BOS,Doc Rivers,81,41,40,6,2,4,1,9,0
2013,BRK,Avery Johnson,28,14,14,0,0,0,1,3,0
2013,BRK,P.J. Carlesimo,54,35,19,7,3,4,2,1,1
2013,CHA,Mike Dunlap,82,21,61,0,0,0,1,1,1
2013,CHI,Tom Thibodeau,82,45,37,12,5,7,1,3,0
2013,CLE,Byron Scott,82,24,58,0,0,0,1,3,0
2013,DAL,Rick Carlisle,82,41,41,0,0,0,1,5,0
2013,DEN,George Karl,82,57,25,6,2,4,1,9,0
2013,DET,Lawrence Frank,82,29,53,0,0,0,1,2,0
2013,GSW,Mark Jackson,82,47,35,12,6,6,1,2,0
2013,HOU,Kevin McHale,82,45,37,6,2,4,1,2,0
2013,IND,Frank Vogel,81,49,32,19,11,8,1,3,0
2013,LAC,Vinny Del Negro,82,56,26,6,2,4,1,3,0
2013,LAL,Mike Brown,5,1,4,0,0,0,1,2,0
2013,LAL,Bernie Bickerstaff,5,4,1,0,0,0,2,1,1
2013,LAL,Mike D'Antoni,72,40,32,4,0,4,3,1,1
2013,MEM,Lionel Hollins,82,56,26,15,8,7,1,7,0
2013,MIA,Erik Spoelstra,82,66,16,23,16,7,1,5,0
2013,MIL,Scott Skiles,32,16,16,0,0,0,1,5,0
2013,MIL,Jim Boylan,50,22,28,4,0,4,2,1,1
2013,MIN,Rick Adelman,82,31,51,0,0,0,1,2,0
2013,NOH,Monty Williams,82,27,55,0,0,0,1,3,0
2013,NYK,Mike Woodson,82,54,28,12,6,6,1,2,0
2013,OKC,Scott Brooks,82,60,22,11,5,6,1,5,0
2013,ORL,Jacque Vaughn,82,20,62,0,0,0,1,1,1
2013,PHI,Doug Collins,82,34,48,0,0,0,1,3,0
2013,PHO,Alvin Gentry,41,13,28,0,0,0,1,5,0
2013,PHO,Lindsey Hunter,41,12,29,0,0,0,2,1,1
2013,POR,Terry Stotts,82,33,49,0,0,0,1,1,1
2013,SAC,Keith Smart,82,28,54,0,0,0,1,2,0
2013,SAS,Gregg Popovich,82,58,24,21,15,6,1,17,0
2013,TOR,Dwane Casey,82,34,48,0,0,0,1,2,0
2013,UTA,Tyrone Corbin,82,43,39,0,0,0,1,3,0
2013,WAS,Randy Wittman,82,29,53,0,0,0,1,2,0
2014,ATL,Mike Budenholzer,82,38,44,7,3,4,1,1,1
2014,BOS,Brad Stevens,82,25,57,0,0,0,1,1,1
2014,BRK,Jason Kidd,82,44,38,12,5,7,1,1,1
2014,CHA,Steve Clifford,82,43,39,4,0,4,1,1,1
2014,CHI,Tom Thibodeau,82,48,34,5,1,4,1,4,0
2014,CLE,Mike Brown,82,33,49,0,0,0,1,6,0
2014,DAL,Rick Carlisle,82,49,33,7,3,4,1,6,0
2014,DEN,Brian Shaw,82,36,46,0,0,0,1,1,1
2014,DET,Maurice Cheeks,50,21,29,0,0,0,1,1,1
2014,DET,John Loyer,32,8,24,0,0,0,2,1,1
2014,GSW,Mark Jackson,82,51,31,7,3,4,1,3,0
2014,HOU,Kevin McHale,82,54,28,6,2,4,1,3,0
2014,IND,Frank Vogel,82,56,26,19,10,9,1,4,0
2014,LAC,Doc Rivers,82,57,25,13,6,7,1,1,1
2014,LAL,Mike D'Antoni,82,27,55,0,0,0,1,2,0
2014,MEM,Dave Joerger,82,50,32,7,3,4,1,1,1
2014,MIA,Erik Spoelstra,82,54,28,20,13,7,1,6,0
2014,MIL,Larry Drew,82,15,67,0,0,0,1,1,1
2014,MIN,Rick Adelman,82,40,42,0,0,0,1,3,0
2014,NOP,Monty Williams,82,34,48,0,0,0,1,4,0
2014,NYK,Mike Woodson,82,37,45,0,0,0,1,3,0
2014,OKC,Scott Brooks,82,59,23,19,10,9,1,6,0
2014,ORL,Jacque Vaughn,82,23,59,0,0,0,1,2,0
2014,PHI,Brett Brown,82,19,63,0,0,0,1,1,1
2014,PHO,Jeff Hornacek,82,48,34,0,0,0,1,1,1
2014,POR,Terry Stotts,82,54,28,11,5,6,1,2,0
2014,SAC,Mike Malone,82,28,54,0,0,0,1,1,1
2014,SAS,Gregg Popovich,82,62,20,23,16,7,1,18,0
2014,TOR,Dwane Casey,82,48,34,7,3,4,1,3,0
2014,UTA,Tyrone Corbin,82,25,57,0,0,0,1,4,0
2014,WAS,Randy Wittman,82,44,38,11,6,5,1,3,0
2015,ATL,Mike Budenholzer,82,60,22,16,8,8,1,2,0
2015,BOS,Brad Stevens,82,40,42,4,0,4,1,2,0
2015,BRK,Lionel Hollins,82,38,44,6,2,4,1,1,1
2015,CHI,Tom Thibodeau,82,50,32,12,6,6,1,5,0
2015,CHO,Steve Clifford,82,33,49,0,0,0,1,2,0
2015,CLE,David Blatt,82,53,29,20,14,6,1,1,1
2015,DAL,Rick Carlisle,82,50,32,5,1,4,1,7,0
2015,DEN,Brian Shaw,59,20,39,0,0,0,1,2,0
2015,DEN,Melvin Hunt,23,10,13,0,0,0,2,1,1
2015,DET,Stan Van Gundy,82,32,50,0,0,0,1,1,1
2015,GSW,Steve Kerr,82,67,15,21,16,5,1,1,1
2015,HOU,Kevin McHale,82,56,26,17,9,8,1,4,0
2015,IND,Frank Vogel,82,38,44,0,0,0,1,5,0
2015,LAC,Doc Rivers,82,56,26,14,7,7,1,2,0
2015,LAL,Byron Scott,82,21,61,0,0,0,1,1,1
2015,MEM,Dave Joerger,82,55,27,11,6,5,1,2,0
2015,MIA,Erik Spoelstra,82,37,45,0,0,0,1,7,0
2015,MIL,Jason Kidd,82,41,41,6,2,4,1,1,1
2015,MIN,Flip Saunders,82,16,66,0,0,0,1,11,0
2015,NOP,Monty Williams,82,45,37,4,0,4,1,5,0
2015,NYK,Derek Fisher,82,17,65,0,0,0,1,1,1
2015,OKC,Scott Brooks,82,45,37,0,0,0,1,7,0
2015,ORL,Jacque Vaughn,52,15,37,0,0,0,1,3,0
2015,ORL,James Borrego,30,10,20,0,0,0,2,1,1
2015,PHI,Brett Brown,82,18,64,0,0,0,1,2,0
2015,PHO,Jeff Hornacek,82,39,43,0,0,0,1,2,0
2015,POR,Terry Stotts,82,51,31,5,1,4,1,3,0
2015,SAC,Mike Malone,24,11,13,0,0,0,1,2,0
2015,SAC,Tyrone Corbin,28,7,21,0,0,0,2,1,1
2015,SAC,George Karl,30,11,19,0,0,0,3,1,1
2015,SAS,Gregg Popovich,82,55,27,7,3,4,1,19,0
2015,TOR,Dwane Casey,82,49,33,4,0,4,1,4,0
2015,UTA,Quin Snyder,82,38,44,0,0,0,1,1,1
2015,WAS,Randy Wittman,82,46,36,10,6,4,1,4,0
2016,ATL,Mike Budenholzer,82,48,34,10,4,6,1,3,0
2016,BOS,Brad Stevens,82,48,34,6,2,4,1,3,0
2016,BRK,Lionel Hollins,37,10,27,0,0,0,1,2,0
2016,BRK,Tony Brown,45,11,34,0,0,0,2,1,1
2016,CHI,Fred Hoiberg,82,42,40,0,0,0,1,1,1
2016,CHO,Steve Clifford,82,48,34,7,3,4,1,3,0
2016,CLE,David Blatt,41,30,11,0,0,0,1,2,0
2016,CLE,Tyronn Lue,41,27,14,21,16,5,2,1,1
2016,DAL,Rick Carlisle,82,42,40,5,1,4,1,8,0
2016,DEN,Mike Malone,82,33,49,0,0,0,1,1,1
2016,DET,Stan Van Gundy,82,44,38,4,0,4,1,2,0
2016,GSW,Steve Kerr,82,73,9,24,15,9,1,2,0
2016,HOU,Kevin McHale,11,4,7,0,0,0,1,5,0
2016,HOU,J.B. Bickerstaff,71,37,34,5,1,4,2,1,1
2016,IND,Frank Vogel,82,45,37,7,3,4,1,6,0
2016,LAC,Doc Rivers,82,53,29,6,2,4,1,3,0
2016,LAL,Byron Scott,82,17,65,0,0,0,1,2,0
2016,MEM,Dave Joerger,82,42,40,4,0,4,1,3,0
2016,MIA,Erik Spoelstra,82,48,34,14,7,7,1,8,0
2016,MIL,Jason Kidd,82,33,49,0,0,0,1,2,0
2016,MIN,Sam Mitchell,82,29,53,0,0,0,1,1,1
2016,NOP,Alvin Gentry,82,30,52,0,0,0,1,1,1
2016,NYK,Derek Fisher,54,23,31,0,0,0,1,2,0
2016,NYK,Kurt Rambis,28,9,19,0,0,0,2,1,1
2016,OKC,Billy Donovan,82,55,27,18,11,7,1,1,1
2016,ORL,Scott Skiles,82,35,47,0,0,0,1,1,1
2016,PHI,Brett Brown,82,10,72,0,0,0,1,3,0
2016,PHO,Jeff Hornacek,49,14,35,0,0,0,1,3,0
2016,PHO,Earl Watson,33,9,24,0,0,0,2,1,1
2016,POR,Terry Stotts,82,44,38,11,5,6,1,4,0
2016,SAC,George Karl,82,33,49,0,0,0,1,2,0
2016,SAS,Gregg Popovich,82,67,15,10,6,4,1,20,0
2016,TOR,Dwane Casey,82,56,26,20,10,10,1,5,0
2016,UTA,Quin Snyder,82,40,42,0,0,0,1,2,0
2016,WAS,Randy Wittman,82,41,41,0,0,0,1,5,0
2017,ATL,Mike Budenholzer,82,43,39,6,2,4,1,4,0
2017,BOS,Brad Stevens,82,53,29,18,9,9,1,4,0
2017,BRK,Kenny Atkinson,82,20,62,0,0,0,1,1,1
2017,CHI,Fred Hoiberg,82,41,41,6,2,4,1,2,0
2017,CHO,Steve Clifford,82,36,46,0,0,0,1,4,0
2017,CLE,Tyronn Lue,82,51,31,18,13,5,1,2,0
2017,DAL,Rick Carlisle,82,33,49,0,0,0,1,9,0
2017,DEN,Mike Malone,82,40,42,0,0,0,1,2,0
2017,DET,Stan Van Gundy,82,37,45,0,0,0,1,3,0
2017,GSW,Steve Kerr,82,67,15,17,16,1,1,3,0
2017,HOU,Mike D'Antoni,82,55,27,11,6,5,1,1,1
2017,IND,Nate McMillan,82,42,40,4,0,4,1,1,1
2017,LAC,Doc Rivers,82,51,31,7,3,4,1,4,0
2017,LAL,Luke Walton,82,26,56,0,0,0,1,1,1
2017,MEM,David Fizdale,82,43,39,6,2,4,1,1,1
2017,MIA,Erik Spoelstra,82,41,41,0,0,0,1,9,0
2017,MIL,Jason Kidd,82,42,40,6,2,4,1,3,0
2017,MIN,Tom Thibodeau,82,31,51,0,0,0,1,1,1
2017,NOP,Alvin Gentry,82,34,48,0,0,0,1,2,0
2017,NYK,Jeff Hornacek,82,31,51,0,0,0,1,1,1
2017,OKC,Billy Donovan,82,47,35,5,1,4,1,2,0
2017,ORL,Frank Vogel,82,29,53,0,0,0,1,1,1
2017,PHI,Brett Brown,82,28,54,0,0,0,1,4,0
2017,PHO,Earl Watson,82,24,58,0,0,0,1,2,0
2017,POR,Terry Stotts,82,41,41,4,0,4,1,5,0
2017,SAC,Dave Joerger,82,32,50,0,0,0,1,1,1
2017,SAS,Gregg Popovich,82,61,21,16,8,8,1,21,0
2017,TOR,Dwane Casey,82,51,31,10,4,6,1,6,0
2017,UTA,Quin Snyder,82,51,31,11,4,7,1,3,0
2017,WAS,Scott Brooks,82,49,33,13,7,6,1,1,1
2018,ATL,Mike Budenholzer,82,24,58,0,0,0,1,5,0
2018,BOS,Brad Stevens,82,55,27,19,11,8,1,5,0
2018,BRK,Kenny Atkinson,82,28,54,0,0,0,1,2,0
2018,CHI,Fred Hoiberg,82,27,55,0,0,0,1,3,0
2018,CHO,Steve Clifford,82,36,46,0,0,0,1,5,0
2018,CLE,Tyronn Lue,82,50,32,22,12,10,1,3,0
2018,DAL,Rick Carlisle,82,24,58,0,0,0,1,10,0
2018,DEN,Mike Malone,82,46,36,0,0,0,1,3,0
2018,DET,Stan Van Gundy,82,39,43,0,0,0,1,4,0
2018,GSW,Steve Kerr,82,58,24,21,16,5,1,4,0
2018,HOU,Mike D'Antoni,82,65,17,17,11,6,1,2,0
2018,IND,Nate McMillan,82,48,34,7,3,4,1,2,0
2018,LAC,Doc Rivers,82,42,40,0,0,0,1,5,0
2018,LAL,Luke Walton,82,35,47,0,0,0,1,2,0
2018,MEM,David Fizdale,19,7,12,0,0,0,1,2,0
2018,MEM,J.B. Bickerstaff,63,15,48,0,0,0,2,1,1
2018,MIA,Erik Spoelstra,82,44,38,5,1,4,1,10,0
2018,MIL,Jason Kidd,45,23,22,0,0,0,1,4,0
2018,MIL,Joe Prunty,37,21,16,7,3,4,2,1,1
2018,MIN,Tom Thibodeau,82,47,35,5,1,4,1,2,0
2018,NOP,Alvin Gentry,82,48,34,9,5,4,1,3,0
2018,NYK,Jeff Hornacek,82,29,53,0,0,0,1,2,0
2018,OKC,Billy Donovan,82,48,34,6,2,4,1,3,0
2018,ORL,Frank Vogel,82,25,57,0,0,0,1,2,0
2018,PHI,Brett Brown,82,52,30,10,5,5,1,5,0
2018,PHO,Earl Watson,3,0,3,0,0,0,1,3,0
2018,PHO,Jay Triano,79,21,58,0,0,0,2,1,1
2018,POR,Terry Stotts,82,49,33,4,0,4,1,6,0
2018,SAC,Dave Joerger,82,27,55,0,0,0,1,2,0
2018,SAS,Gregg Popovich,82,47,35,5,1,4,1,22,0
2018,TOR,Dwane Casey,82,59,23,10,4,6,1,7,0
2018,UTA,Quin Snyder,82,48,34,11,5,6,1,4,0
2018,WAS,Scott Brooks,82,43,39,6,2,4,1,2,0
2019,ATL,Lloyd Pierce,82,29,53,0,0,0,1,1,1
2019,BOS,Brad Stevens,82,49,33,9,5,4,1,6,0
2019,BRK,Kenny Atkinson,82,42,40,5,1,4,1,3,0
2019,CHI,Fred Hoiberg,24,5,19,0,0,0,1,4,0
2019,CHI,Jim Boylen,58,17,41,0,0,0,2,1,1
2019,CHO,James Borrego,82,39,43,0,0,0,1,1,1
2019,CLE,Tyronn Lue,6,0,6,0,0,0,1,4,0
2019,CLE,Larry Drew,76,19,57,0,0,0,2,1,1
2019,DAL,Rick Carlisle,82,33,49,0,0,0,1,11,0
2019,DEN,Mike Malone,82,54,28,14,7,7,1,4,0
2019,DET,Dwane Casey,82,41,41,4,0,4,1,1,1
2019,GSW,Steve Kerr,82,57,25,22,14,8,1,5,0
2019,HOU,Mike D'Antoni,82,53,29,11,6,5,1,3,0
2019,IND,Nate McMillan,82,48,34,4,0,4,1,3,0
2019,LAC,Doc Rivers,82,48,34,6,2,4,1,6,0
2019,LAL,Luke Walton,82,37,45,0,0,0,1,3,0
2019,MEM,J.B. Bickerstaff,82,33,49,0,0,0,1,2,0
2019,MIA,Erik Spoelstra,82,39,43,0,0,0,1,11,0
2019,MIL,Mike Budenholzer,82,60,22,15,10,5,1,1,1
2019,MIN,Tom Thibodeau,40,19,21,0,0,0,1,3,0
2019,MIN,Ryan Saunders,42,17,25,0,0,0,2,1,1
2019,NOP,Alvin Gentry,82,33,49,0,0,0,1,4,0
2019,NYK,David Fizdale,82,17,65,0,0,0,1,1,1
2019,OKC,Billy Donovan,82,49,33,5,1,4,1,4,0
2019,ORL,Steve Clifford,82,42,40,5,1,4,1,1,1
2019,PHI,Brett Brown,82,51,31,12,7,5,1,6,0
2019,PHO,Igor Kokoskov,82,19,63,0,0,0,1,1,1
2019,POR,Terry Stotts,82,53,29,16,8,8,1,7,0
2019,SAC,Dave Joerger,82,39,43,0,0,0,1,3,0
2019,SAS,Gregg Popovich,82,48,34,7,3,4,1,23,0
2019,TOR,Nick Nurse,82,58,24,24,16,8,1,1,1
2019,UTA,Quin Snyder,82,50,32,5,1,4,1,5,0
2019,WAS,Scott Brooks,82,32,50,0,0,0,1,3,0
2020,ATL,Lloyd Pierce,67,20,47,0,0,0,1,2,0
2020,BOS,Brad Stevens,72,48,24,1,1,0,1,7,0
2020,BRK,Kenny Atkinson,62,28,34,0,0,0,1,4,0
2020,BRK,Jacque Vaughn,10,7,3,1,0,1,2,1,1
2020,CHI,Jim Boylen,65,22,43,0,0,0,1,2,0
2020,CHO,James Borrego,65,23,42,0,0,0,1,2,0
2020,CLE,John Beilein,54,14,40,0,0,0,1,1,1
2020,CLE,J.B. Bickerstaff,11,5,6,0,0,0,2,1,1
2020,DAL,Rick Carlisle,75,43,32,1,0,1,1,12,0
2020,DEN,Mike Malone,73,46,27,1,1,0,1,5,0
2020,DET,Dwane Casey,66,20,46,0,0,0,1,2,0
2020,GSW,Steve Kerr,65,15,50,0,0,0,1,6,0
2020,HOU,Mike D'Antoni,72,44,28,1,1,0,1,4,0
2020,IND,Nate McMillan,73,45,28,1,0,1,1,4,0
2020,LAC,Doc Rivers,72,49,23,1,1,0,1,7,0
2020,LAL,Frank Vogel,71,52,19,1,0,1,1,1,1
2020,MEM,Taylor Jenkins,74,34,40,0,0,0,1,1,1
2020,MIA,Erik Spoelstra,73,44,29,1,1,0,1,12,0
2020,MIL,Mike Budenholzer,73,56,17,1,0,1,1,2,0
2020,MIN,Ryan Saunders,64,19,45,0,0,0,1,2,0
2020,NOP,Alvin Gentry,72,30,42,0,0,0,1,5,0
2020,NYK,David Fizdale,22,4,18,0,0,0,1,2,0
2020,NYK,Mike Miller,44,17,27,0,0,0,2,1,1
2020,NYK,Tom Thibodeau,0,0,0,0,0,0,3,1,1
2020,OKC,Billy Donovan,72,44,28,1,0,1,1,5,0
2020,ORL,Steve Clifford,73,33,40,1,1,0,1,2,0
2020,PHI,Brett Brown,73,43,30,1,0,1,1,7,0
2020,PHO,Monty Williams,73,34,39,0,0,0,1,1,1
2020,POR,Terry Stotts,75,36,39,1,1,0,1,8,0
2020,SAC,Luke Walton,72,31,41,0,0,0,1,1,1
2020,SAS,Gregg Popovich,71,32,39,0,0,0,1,24,0
2020,TOR,Nick Nurse,72,53,19,1,1,0,1,2,0
2020,UTA,Quin Snyder,72,44,28,1,0,1,1,6,0
2020,WAS,Scott Brooks,72,25,47,0,0,0,1,4,0
